Datum;Buchungstext;Betrag;Saldo;Valuta
24.07.23;Addebito TWINT SBB EasyRide 0400001501694176;-6.10;114863.38;24.07.23
24.07.23;Pagamento stipendio Cembra Money Bank AG;6957.00;114869.48;24.07.23
24.07.23;Eft-Pos - blue Cinema abaton ZH, Zurich - 20.07.2023 19:51 - N. di carta xxxxxxxxxxxx4476 - 8.20 CHF;-8.20;107912.48;20.07.23
21.07.23;Addebito TWINT SBB EasyRide 0400001496247113;-6.40;107920.68;21.07.23
21.07.23;Eft-Pos - BRISKET ZUERICH, ZUERICH - 19.07.2023 21:26 - N. di carta xxxxxxxxxxxx4476 - 110.50 CHF;-110.50;107927.08;19.07.23
20.07.23;Dauerauftrag;-1090.00;108037.58;20.07.23
20.07.23;Eft-Pos - Restaurant A1 M.O.V.E., Zurich - 18.07.2023 12:06 - N. di carta xxxxxxxxxxxx4476 - 8.50 CHF;-8.50;109127.58;18.07.23
19.07.23;Addebito TWINT SBB EasyRide 0400001492222976;-6.10;109136.08;19.07.23
19.07.23;Eft-Pos - Restaurant A1 M.O.V.E., Zurich - 17.07.2023 12:59 - N. di carta xxxxxxxxxxxx4476 - 8.50 CHF;-8.50;109142.18;17.07.23
18.07.23;Addebito TWINT SBB EasyRide 0400001490286029;-6.10;109150.68;18.07.23
18.07.23;Eft-Pos - LANDI Regensdorf Genosse, Adlikon B.Reg - 15.07.2023 15:46 - N. di carta xxxxxxxxxxxx4476 - 40.90 CHF;-40.90;109156.78;15.07.23
18.07.23;Eft-Pos - Migros MM Regensdorf, Regensdorf - 15.07.2023 19:30 - N. di carta xxxxxxxxxxxx4476 - 13.70 CHF;-13.70;109197.68;15.07.23
18.07.23;Eft-Pos - Coop-5079 ZH Oerlikon Bh, Zurich - 14.07.2023 21:56 - N. di carta xxxxxxxxxxxx4476 - 1.15 CHF;-1.15;109211.38;14.07.23
17.07.23;Addebito TWINT SBB EasyRide 0400001486962133;-6.10;109212.53;16.07.23
14.07.23;Belastung LSV;-7.16;109218.63;14.07.23
14.07.23;Eft-Pos - Restaurant A1 M.O.V.E., Zurich - 12.07.2023 12:48 - N. di carta xxxxxxxxxxxx4476 - 8.50 CHF;-8.50;109225.79;12.07.23
13.07.23;Addebito TWINT SBB EasyRide 0400001480311558;-4.40;109234.29;13.07.23
12.07.23;Eft-Pos - Denner Regensdorf, Regensdorf - 10.07.2023 18:00 - N. di carta xxxxxxxxxxxx4476 - 20.05 CHF;-20.05;109238.69;10.07.23
10.07.23;Belastung LSV;-7.00;109258.74;10.07.23
10.07.23;Addebito TWINT Ogg The Farmer 0400001471606212;-10.50;109265.74;08.07.23
10.07.23;Eft-Pos - Lidl Regensdorf, Regensdorf - 06.07.2023 20:28 - N. di carta xxxxxxxxxxxx4476 - 67.90 CHF;-67.90;109276.24;06.07.23
06.07.23;Eft-Pos - Restaurant A1 M.O.V.E., Zurich - 04.07.2023 12:12 - N. di carta xxxxxxxxxxxx4476 - 8.50 CHF;-8.50;109344.14;04.07.23
05.07.23;Addebito TWINT SBB EasyRide 0400001462055250;-6.10;109352.64;05.07.23
04.07.23;Eft-Pos - JUMBO-2017 Regensdorf, Regensdorf - 01.07.2023 17:50 - N. di carta xxxxxxxxxxxx4476 - 37.65 CHF;-37.65;109358.74;01.07.23
04.07.23;Eft-Pos - JUMBO-2017 Regensdorf, Regensdorf - 01.07.2023 11:52 - N. di carta xxxxxxxxxxxx4476 - 22.95 CHF;-22.95;109396.39;01.07.23
04.07.23;Eft-Pos - LANDI Regensdorf Genosse, Adlikon B.Reg - 01.07.2023 15:31 - N. di carta xxxxxxxxxxxx4476 - 118.95 CHF;-118.95;109419.34;01.07.23
03.07.23;Addebito TWINT SBB EasyRide 0400001453084707;-3.40;109538.29;01.07.23
03.07.23;Eft-Pos - Coop TS Regensdorf, Regensdorf - 29.06.2023 22:27 - N. di carta xxxxxxxxxxxx4476 - 6.90 CHF;-6.90;109541.69;29.06.23
03.07.23;Eft-Pos - Migros M EX Sihlpassage, Zurich - 29.06.2023 15:11 - N. di carta xxxxxxxxxxxx4476 - 1.15 CHF;-1.15;109548.59;29.06.23
30.06.23;Belastung LSV;-350.20;109549.74;30.06.23
30.06.23;Verg�tung;-64.00;109899.94;30.06.23
28.06.23;Eft-Pos - Medbase Apotheke Zurich, Zurich - 26.06.2023 09:13 - N. di carta xxxxxxxxxxxx4476 - 21.15 CHF;-21.15;109963.94;26.06.23
28.06.23;Eft-Pos - Coop-5307 ZH Hauptbhf to, Zurich - 26.06.2023 09:03 - N. di carta xxxxxxxxxxxx4476 - 5.70 CHF;-5.70;109985.09;26.06.23
28.06.23;Eft-Pos - Coop-4899 Zurich Bahnhof, Zurich 1 Sihl - 26.06.2023 09:20 - N. di carta xxxxxxxxxxxx4476 - 6.25 CHF;-6.25;109990.79;26.06.23
27.06.23;Eft-Pos - SOCAR Tankstelle, Regensdorf - 25.06.2023 17:57 - N. di carta xxxxxxxxxxxx4476 - 12.40 CHF;-12.40;109997.04;25.06.23
27.06.23;Eft-Pos - Migros MM Regensdorf, Regensdorf - 24.06.2023 19:41 - N. di carta xxxxxxxxxxxx4476 - 70.35 CHF;-70.35;110009.44;24.06.23
27.06.23;Eft-Pos - Coop-1736 ZH Romerhof, Zurich - 23.06.2023 18:32 - N. di carta xxxxxxxxxxxx4476 - 4.95 CHF;-4.95;110079.79;23.06.23
27.06.23;Eft-Pos - BRISKET GMBH, ZUERICH - 23.06.2023 21:34 - N. di carta xxxxxxxxxxxx4476 - 115.00 CHF;-115.00;110084.74;23.06.23
26.06.23;Addebito TWINT SBB EasyRide 0400001438508885;-9.50;110199.74;25.06.23
23.06.23;Pagamento stipendio Cembra Money Bank AG;6939.00;110209.24;23.06.23
22.06.23;Addebito TWINT bs-plus.ch, beauz.ch 0400001431904725;-29.50;103270.24;22.06.23
22.06.23;Eft-Pos - Restaurant A1 M.O.V.E., Zurich - 20.06.2023 12:19 - N. di carta xxxxxxxxxxxx4476 - 9.50 CHF;-9.50;103299.74;20.06.23
21.06.23;Addebito TWINT SBB EasyRide 0400001428352923;-6.10;103309.24;21.06.23
20.06.23;Dauerauftrag;-1090.00;103315.34;20.06.23
20.06.23;Eft-Pos - Coop TS Regensdorf, Regensdorf - 17.06.2023 11:08 - N. di carta xxxxxxxxxxxx4476 - 12.99 CHF;-12.99;104405.34;17.06.23
20.06.23;Eft-Pos - LANDI Regensdorf Genosse, Adlikon B.Reg - 17.06.2023 11:35 - N. di carta xxxxxxxxxxxx4476 - 49.45 CHF;-49.45;104418.33;17.06.23
20.06.23;Eft-Pos - AKSA FOOD HONGG AG, ZURICH - 17.06.2023 12:13 - N. di carta xxxxxxxxxxxx4476 - 95.50 CHF;-95.50;104467.78;17.06.23
19.06.23;Eft-Pos - Lidl Regensdorf, Regensdorf - 15.06.2023 20:00 - N. di carta xxxxxxxxxxxx4476 - 42.30 CHF;-42.30;104563.28;15.06.23
16.06.23;Addebito TWINT Bundesamt f�r Justiz 0400001418492123;-17.00;104605.58;16.06.23
14.06.23;Belastung LSV;-142.85;104622.58;14.06.23
13.06.23;Eft-Pos - Aldi Suisse 53, Chiasso - 10.06.2023 17:17 - N. di carta xxxxxxxxxxxx4476 - 40.35 CHF;-40.35;104765.43;10.06.23
13.06.23;Eft-Pos - Coop-2482 Chiasso, Chiasso - 10.06.2023 20:58 - N. di carta xxxxxxxxxxxx4476 - 8.20 CHF;-8.20;104805.78;10.06.23
13.06.23;Eft-Pos - Migrol Service, Zug - 09.06.2023 10:43 - N. di carta xxxxxxxxxxxx4476 - 58.88 CHF;-58.88;104813.98;09.06.23
08.06.23;Eft-Pos - Restaurant A1 M.O.V.E., Zurich - 06.06.2023 12:22 - N. di carta xxxxxxxxxxxx4476 - 9.50 CHF;-9.50;104872.86;06.06.23
07.06.23;Addebito TWINT SBB EasyRide 0400001396932833;-6.10;104882.36;07.06.23
06.06.23;Eft-Pos - Coop TS Regensdorf, Regensdorf - 04.06.2023 12:59 - N. di carta xxxxxxxxxxxx4476 - 4.90 CHF;-4.90;104888.46;04.06.23
06.06.23;Eft-Pos - AKSA FOOD HONGG AG, ZURICH - 03.06.2023 11:05 - N. di carta xxxxxxxxxxxx4476 - 88.45 CHF;-88.45;104893.36;03.06.23
06.06.23;Eft-Pos - Lidl Regensdorf, Regensdorf - 03.06.2023 19:48 - N. di carta xxxxxxxxxxxx4476 - 140.55 CHF;-140.55;104981.81;03.06.23
06.06.23;Eft-Pos - SUMUP  KIOSK KATZENSEE, ZURICH - 03.06.2023 16:44 - N. di carta xxxxxxxxxxxx4476 - 3.80 CHF;-3.80;105122.36;03.06.23
05.06.23;Belastung LSV;-7.00;105126.16;05.06.23
05.06.23;Addebito TWINT SBB EasyRide 0400001390733564;-4.10;105133.16;04.06.23
05.06.23;Addebito TWINT Ogg The Farmer 0400001389941860;-11.00;105137.26;03.06.23
02.06.23;Eft-Pos - LANDI Regensdorf Genosse, Adlikon B.Reg - 31.05.2023 18:21 - N. di carta xxxxxxxxxxxx4476 - 64.25 CHF;-64.25;105148.26;31.05.23
01.06.23;Eft-Pos - LANDI Regensdorf Genosse, Adlikon B.Reg - 30.05.2023 17:58 - N. di carta xxxxxxxxxxxx4476 - 66.75 CHF;-66.75;105212.51;30.05.23
01.06.23;Eft-Pos - Restaurant A1 M.O.V.E., Zurich - 30.05.2023 12:11 - N. di carta xxxxxxxxxxxx4476 - 9.50 CHF;-9.50;105279.26;30.05.23
31.05.23;Addebito TWINT SBB EasyRide 0400001380633756;-4.10;105288.76;31.05.23
31.05.23;Belastung LSV;-350.20;105292.86;31.05.23
31.05.23;Verg�tung;-64.00;105643.06;31.05.23
31.05.23;Eft-Pos - Lidl Regensdorf, Regensdorf - 27.05.2023 19:04 - N. di carta xxxxxxxxxxxx4476 - 39.25 CHF;-39.25;105707.06;27.05.23
31.05.23;Eft-Pos - LANDI Regensdorf Genosse, Adlikon B.Reg - 27.05.2023 14:48 - N. di carta xxxxxxxxxxxx4476 - 31.95 CHF;-31.95;105746.31;27.05.23
31.05.23;Eft-Pos - Denner Regensdorf, Regensdorf - 27.05.2023 19:19 - N. di carta xxxxxxxxxxxx4476 - 70.00 CHF;-70.00;105778.26;27.05.23
30.05.23;Addebito TWINT (Sofa), Siminia, +41779778472 0400001371802284;-400.00;105848.26;26.05.23
30.05.23;Eft-Pos - Lidl Regensdorf, Regensdorf - 25.05.2023 20:46 - N. di carta xxxxxxxxxxxx4476 - 84.60 CHF;-84.60;106248.26;25.05.23
24.05.23;Pagamento stipendio Cembra Money Bank AG;6939.00;106332.86;24.05.23
23.05.23;Addebito TWINT SBB EasyRide 0400001362604363;-6.10;99393.86;23.05.23
23.05.23;Eft-Pos - Lidl Regensdorf, Regensdorf - 20.05.2023 19:40 - N. di carta xxxxxxxxxxxx4476 - 25.40 CHF;-25.40;99399.96;20.05.23
23.05.23;Eft-Pos - Paddy Reillys AG, Zurich - 19.05.2023 22:34 - N. di carta xxxxxxxxxxxx4476 - 18.60 CHF;-18.60;99425.36;19.05.23
22.05.23;Addebito TWINT SBB EasyRide 0400001357237308;-6.10;99443.96;20.05.23
19.05.23;Dauerauftrag;-1090.00;99450.06;19.05.23
19.05.23;Addebito TWINT Ogg The Farmer 0400001354217485;-16.10;100540.06;18.05.23
19.05.23;Eft-Pos - Restaurant A1 M.O.V.E., Zurich - 16.05.2023 12:13 - N. di carta xxxxxxxxxxxx4476 - 8.50 CHF;-8.50;100556.16;16.05.23
17.05.23;Addebito TWINT SBB EasyRide 0400001351306457;-3.40;100564.66;17.05.23
17.05.23;Eft-Pos - Restaurant A1 M.O.V.E., Zurich - 15.05.2023 13:05 - N. di carta xxxxxxxxxxxx4476 - 8.50 CHF;-8.50;100568.06;15.05.23
17.05.23;Eft-Pos - Lidl Regensdorf, Regensdorf - 13.05.2023 14:53 - N. di carta xxxxxxxxxxxx4476 - 39.95 CHF;-39.95;100576.56;13.05.23
17.05.23;Eft-Pos - Coop TS Prime Tower, Zurich - 12.05.2023 19:28 - N. di carta xxxxxxxxxxxx4476 - 1.15 CHF;-1.15;100616.51;12.05.23
16.05.23;Addebito TWINT SBB EasyRide 0400001349242692;-6.10;100617.66;16.05.23
15.05.23;Addebito TWINT SBB EasyRide 0400001345731537;-6.10;100623.76;14.05.23
10.05.23;Eft-Pos - Lidl Regensdorf, Regensdorf - 08.05.2023 19:40 - N. di carta xxxxxxxxxxxx4476 - 22.30 CHF;-22.30;100629.86;08.05.23
09.05.23;Addebito TWINT Ogg The Farmer 0400001335935310;-12.20;100652.16;09.05.23
09.05.23;Eft-Pos - UZRK.-P. Kohl & D. Posz, Hamburg - 07.05.2023 10:10 - N. di carta xxxxxxxxxxxx4476 - 3.90 EUR al tasso di cambio 0.992308 = CHF 3.87 Piu commisioni CHF 1.50;-5.37;100664.36;07.05.23
09.05.23;Eft-Pos - NUR HIER 3076, PINNEBERG - 06.05.2023 15:52 - N. di carta xxxxxxxxxxxx4476 - 17.29 EUR al tasso di cambio 0.99306 = CHF 17.17 Piu commisioni CHF 1.50;-18.67;100669.73;06.05.23
09.05.23;Eft-Pos - FANOE BRYGHUS, FANOE - 05.05.2023 17:43 - N. di carta xxxxxxxxxxxx4476 - 190.00 DKK al tasso di cambio 0.134579 = CHF 25.57 Piu commisioni CHF 1.50;-27.07;100688.40;05.05.23
09.05.23;Eft-Pos - FANOE BRYGHUS, FANOE - 05.05.2023 17:50 - N. di carta xxxxxxxxxxxx4476 - 30.00 DKK al tasso di cambio 0.134667 = CHF 4.04 Piu commisioni CHF 1.50;-5.54;100715.47;05.05.23
09.05.23;Eft-Pos - SUPERBRUGSEN NORDBY, FANOE - 05.05.2023 19:01 - N. di carta xxxxxxxxxxxx4476 - 139.20 DKK al tasso di cambio 0.134555 = CHF 18.73 Piu commisioni CHF 1.50;-20.23;100721.01;05.05.23
09.05.23;Eft-Pos - SUMUP  VADEMAD APS, FANO - 05.05.2023 17:32 - N. di carta xxxxxxxxxxxx4476 - 130.00 DKK al tasso di cambio 0.134538 = CHF 17.49 Piu commisioni CHF 1.50;-18.99;100741.24;05.05.23
08.05.23;Addebito TWINT SBB EasyRide 0400001332302885;-3.40;100760.23;08.05.23
08.05.23;Eft-Pos - DAGLIBRUGSEN SOENDERHO, FANOE - 04.05.2023 15:04 - N. di carta xxxxxxxxxxxx4476 - 76.95 DKK al tasso di cambio 0.134893 = CHF 10.38 Piu commisioni CHF 1.50;-11.88;100763.63;04.05.23
05.05.23;Eft-Pos - Zettle_Fano Supermarked, Fano - 03.05.2023 12:18 - N. di carta xxxxxxxxxxxx4476 - 525.00 DKK al tasso di cambio 0.135029 = CHF 70.89 Piu commisioni CHF 1.50;-72.39;100775.51;03.05.23
05.05.23;Eft-Pos - SUPERBRUGSEN NORDBY, FANOE - 03.05.2023 19:00 - N. di carta xxxxxxxxxxxx4476 - 131.65 DKK al tasso di cambio 0.135055 = CHF 17.78 Piu commisioni CHF 1.50;-19.28;100847.90;03.05.23
03.05.23;Eft-Pos - SPAR FANOE, FANOE - 01.05.2023 15:05 - N. di carta xxxxxxxxxxxx4476 - 277.00 DKK al tasso di cambio 0.134874 = CHF 37.36 Piu commisioni CHF 1.50;-38.86;100867.18;01.05.23
03.05.23;Eft-Pos - ESBJERG STREET FOOD AF 2, ESBJERG - 29.04.2023 13:57 - N. di carta xxxxxxxxxxxx4476 - 89.00 DKK al tasso di cambio 0.134831 = CHF 12.00 Piu commisioni CHF 1.50;-13.50;100906.04;29.04.23
02.05.23;Belastung LSV;-7.00;100919.54;02.05.23
02.05.23;Belastung LSV;-350.20;100926.54;02.05.23
28.04.23;Addebito TWINT SBB EasyRide 0400001310748722;-3.40;101276.74;28.04.23
28.04.23;Verg�tung;-67.40;101280.14;28.04.23
27.04.23;Eft-Pos - Restaurant A1 M.O.V.E., Zurich - 25.04.2023 12:25 - N. di carta xxxxxxxxxxxx4476 - 9.50 CHF;-9.50;101347.54;25.04.23
26.04.23;Addebito TWINT SBB EasyRide 0400001306166782;-6.10;101357.04;26.04.23
25.04.23;Eft-Pos - Coop TS Regensdorf, Regensdorf - 23.04.2023 12:48 - N. di carta xxxxxxxxxxxx4476 - 2.95 CHF;-2.95;101363.14;23.04.23
25.04.23;Eft-Pos - Lidl Regensdorf, Regensdorf - 22.04.2023 18:41 - N. di carta xxxxxxxxxxxx4476 - 109.35 CHF;-109.35;101366.09;22.04.23
24.04.23;Pagamento stipendio Cembra Money Bank AG;6939.00;101475.44;24.04.23
24.04.23;Addebito TWINT Ogg The Farmer 0400001301464025;-6.00;94536.44;23.04.23
24.04.23;Eft-Pos - Lidl Regensdorf, Regensdorf - 20.04.2023 19:35 - N. di carta xxxxxxxxxxxx4476 - 75.60 CHF;-75.60;94542.44;20.04.23
20.04.23;Dauerauftrag;-1090.00;94618.04;20.04.23
20.04.23;Eft-Pos - Restaurant A1 M.O.V.E., Zurich - 18.04.2023 12:22 - N. di carta xxxxxxxxxxxx4476 - 9.50 CHF;-9.50;95708.04;18.04.23
19.04.23;Addebito TWINT SBB EasyRide App 0400001292425741;-6.10;95717.54;19.04.23
18.04.23;Addebito TWINT Ogg The Farmer 0400001291913324;-6.00;95723.64;18.04.23
18.04.23;Eft-Pos - Coop-2829 Dietikon Silbe, Dietikon - 15.04.2023 14:23 - N. di carta xxxxxxxxxxxx4476 - 9.40 CHF;-9.40;95729.64;15.04.23
18.04.23;Eft-Pos - FRISCH-FISCH MERCATO, DIETLIKON - 15.04.2023 15:34 - N. di carta xxxxxxxxxxxx4476 - 206.60 CHF;-206.60;95739.04;15.04.23
18.04.23;Eft-Pos - Lidl Regensdorf, Regensdorf - 14.04.2023 19:38 - N. di carta xxxxxxxxxxxx4476 - 54.35 CHF;-54.35;95945.64;14.04.23
14.04.23;Belastung LSV;-297.30;95999.99;14.04.23
14.04.23;Addebito TWINT Ogg The Farmer 0400001283132893;-6.00;96297.29;13.04.23
14.04.23;Eft-Pos - MCDONALDS REGENSDORF, REGENSDORF - 11.04.2023 19:32 - N. di carta xxxxxxxxxxxx4476 - 68.10 CHF;-68.10;96303.29;11.04.23
13.04.23;Eft-Pos - Lidl Regensdorf, Regensdorf - 11.04.2023 18:14 - N. di carta xxxxxxxxxxxx4476 - 14.35 CHF;-14.35;96371.39;11.04.23
12.04.23;Eft-Pos - Bass Center, Schlieren - 08.04.2023 16:01 - N. di carta xxxxxxxxxxxx4476 - 15.00 CHF;-15.00;96385.74;08.04.23
12.04.23;Eft-Pos - AKSA FOOD HONGG AG, ZURICH - 08.04.2023 12:32 - N. di carta xxxxxxxxxxxx4476 - 98.80 CHF;-98.80;96400.74;08.04.23
12.04.23;Eft-Pos - Coop TS Prime Tower, Zurich - 06.04.2023 20:00 - N. di carta xxxxxxxxxxxx4476 - 1.15 CHF;-1.15;96499.54;06.04.23
12.04.23;Eft-Pos - BRISKET GMBH, ZUERICH - 06.04.2023 21:55 - N. di carta xxxxxxxxxxxx4476 - 36.00 CHF;-36.00;96500.69;06.04.23
12.04.23;Eft-Pos - Lidl Regensdorf, Regensdorf - 06.04.2023 18:51 - N. di carta xxxxxxxxxxxx4476 - 13.70 CHF;-13.70;96536.69;06.04.23
11.04.23;Addebito TWINT SBB EasyRide App 0400001272202580;-6.10;96550.39;07.04.23
11.04.23;Eft-Pos - STARBUCKS 032180, ZURICH - 05.04.2023 19:45 - N. di carta xxxxxxxxxxxx4476 - 8.90 CHF;-8.90;96556.49;05.04.23
11.04.23;Eft-Pos - AKSA FOOD HONGG AG, ZURICH - 05.04.2023 20:10 - N. di carta xxxxxxxxxxxx4476 - 8.85 CHF;-8.85;96565.39;05.04.23
06.04.23;Eft-Pos - Restaurant A1 M.O.V.E., Zurich - 04.04.2023 11:58 - N. di carta xxxxxxxxxxxx4476 - 9.50 CHF;-9.50;96574.24;04.04.23
05.04.23;Addebito TWINT SBB EasyRide App 0400001267672257;-6.10;96583.74;05.04.23
04.04.23;Eft-Pos - Volg Laden Watt, Watt - 01.04.2023 18:13 - N. di carta xxxxxxxxxxxx4476 - 14.60 CHF;-14.60;96589.84;01.04.23
04.04.23;Eft-Pos - Lidl Regensdorf, Regensdorf - 31.03.2023 19:26 - N. di carta xxxxxxxxxxxx4476 - 98.70 CHF;-98.70;96604.44;31.03.23
03.04.23;Zahlungseingang;6000.00;96703.14;03.04.23
03.04.23;Belastung LSV;-7.00;90703.14;03.04.23
03.04.23;Addebito TWINT Ogg The Farmer 0400001261452604;-6.00;90710.14;01.04.23
31.03.23;Belastung LSV;-350.20;90716.14;31.03.23
31.03.23;Verg�tung;-64.00;91066.34;31.03.23
30.03.23;Addebito TWINT Ogg The Farmer 0400001257019678;-6.00;91130.34;30.03.23
30.03.23;Eft-Pos - Restaurant A1 M.O.V.E., Zurich - 28.03.2023 12:33 - N. di carta xxxxxxxxxxxx4476 - 8.50 CHF;-8.50;91136.34;28.03.23
30.03.23;Eft-Pos - Coop-5629 ZH Vulkanstras, Zurich - 28.03.2023 12:37 - N. di carta xxxxxxxxxxxx4476 - 1.40 CHF;-1.40;91144.84;28.03.23
29.03.23;Addebito TWINT SBB EasyRide App 0400001253316630;-6.10;91146.24;29.03.23
28.03.23;Eft-Pos - Migros MMM Tivoli, Spreitenbach - 25.03.2023 18:59 - N. di carta xxxxxxxxxxxx4476 - 206.40 CHF;-206.40;91152.34;25.03.23
28.03.23;Eft-Pos - Ochsner Shoes / 606, Spreitenbach - 25.03.2023 17:43 - N. di carta xxxxxxxxxxxx4476 - 50.15 CHF;-50.15;91358.74;25.03.23
28.03.23;Eft-Pos - C & A Mode Spreitenbach, Spreitenbach - 25.03.2023 17:30 - N. di carta xxxxxxxxxxxx4476 - 30.25 CHF;-30.25;91408.89;25.03.23
27.03.23;Addebito TWINT , Maria, +41794363707 0400001250702464;-30.00;91439.14;27.03.23
27.03.23;Verg�tung;-5000.00;91469.14;27.03.23
24.03.23;Pagamento stipendio Cembra Money Bank AG;10024.75;96469.14;24.03.23
24.03.23;Eft-Pos - IKEA AG, Spreitenbach (A, Spreitenbach - 22.03.2023 19:39 - N. di carta xxxxxxxxxxxx4476 - 53.75 CHF;-53.75;86444.39;22.03.23
23.03.23;Eft-Pos - Coop-2572 Regensdorf/Rag, Regensdorf - 21.03.2023 18:37 - N. di carta xxxxxxxxxxxx4476 - 34.20 CHF;-34.20;86498.14;21.03.23
23.03.23;Eft-Pos - Restaurant A1 M.O.V.E., Zurich - 21.03.2023 12:12 - N. di carta xxxxxxxxxxxx4476 - 8.50 CHF;-8.50;86532.34;21.03.23
22.03.23;Addebito TWINT SBB EasyRide App 0400001239104875;-6.10;86540.84;22.03.23
21.03.23;Eft-Pos - Lidl Regensdorf, Regensdorf - 18.03.2023 18:32 - N. di carta xxxxxxxxxxxx4476 - 37.90 CHF;-37.90;86546.94;18.03.23
21.03.23;Eft-Pos - Migros MM Regensdorf, Regensdorf - 18.03.2023 17:50 - N. di carta xxxxxxxxxxxx4476 - 2.25 CHF;-2.25;86584.84;18.03.23
20.03.23;Addebito TWINT SBB EasyRide App 0400001235442173;-6.10;86587.09;20.03.23
20.03.23;Dauerauftrag;-1090.00;86593.19;20.03.23
20.03.23;Addebito TWINT SBB EasyRide App 0400001234149423;-2.30;87683.19;19.03.23
16.03.23;Eft-Pos - Restaurant A1 M.O.V.E., Zurich - 14.03.2023 12:08 - N. di carta xxxxxxxxxxxx4476 - 8.50 CHF;-8.50;87685.49;14.03.23
16.03.23;Eft-Pos - LA NUOVA SFOGLIATELLA DI, MONTEVARCHI - 13.03.2023 09:27 - N. di carta xxxxxxxxxxxx4476 - 9.40 EUR al tasso di cambio 1.001064 = CHF 9.41 Piu commisioni CHF 1.50;-10.91;87693.99;13.03.23
15.03.23;Addebito TWINT Srebniak, Karolina, +41763218440 0400001226185212;-20.00;87704.90;15.03.23
15.03.23;Addebito TWINT SBB EasyRide App 0400001226008352;-3.40;87724.90;15.03.23
15.03.23;Eft-Pos - MISER DIREZ.ENTRATA  -, TERRAZZANO BA - 13.03.2023 15:27 - N. di carta xxxxxxxxxxxx4476 - 3.30 EUR al tasso di cambio 1 = CHF 3.30 Piu commisioni CHF 1.50;-4.80;87728.30;13.03.23
15.03.23;Eft-Pos - METANAUTO SRL, MONTEVARCHI - 13.03.2023 09:05 - N. di carta xxxxxxxxxxxx4476 - 45.01 EUR al tasso di cambio 1.001111 = CHF 45.06 Piu commisioni CHF 1.50;-46.56;87733.10;13.03.23
14.03.23;Addebito TWINT SBB Mobile 0400001224243126;-3.10;87779.66;14.03.23
14.03.23;Verg�tung;-550.00;87782.76;14.03.23
14.03.23;Eft-Pos - IPER MONTEVARCHI, MONTEVARCHI - 10.03.2023 14:12 - N. di carta xxxxxxxxxxxx4476 - 451.24 EUR al tasso di cambio 1.003524 = CHF 452.83 Piu commisioni CHF 1.50;-454.33;88332.76;10.03.23
09.03.23;Eft-Pos - LA NUOVA SFOGLIATELLA DI, MONTEVARCHI - 06.03.2023 16:24 - N. di carta xxxxxxxxxxxx4476 - 10.20 EUR al tasso di cambio 1.010784 = CHF 10.31 Piu commisioni CHF 1.50;-11.81;88787.09;06.03.23
07.03.23;Eft-Pos - Post CH AG (8364) Regens, Regensdorf - 03.03.2023 18:49 - N. di carta xxxxxxxxxxxx4476 - 50.00 CHF;-50.00;88798.90;03.03.23
06.03.23;Addebito TWINT SBB EasyRide App 0400001205354620;-6.10;88848.90;04.03.23
02.03.23;Eft-Pos - Koscher Bagel GmbH, Zurich - 28.02.2023 11:20 - N. di carta xxxxxxxxxxxx4476 - 26.00 CHF;-26.00;88855.00;28.02.23
01.03.23;Addebito TWINT SBB EasyRide App 0400001198961395;-6.10;88881.00;01.03.23
01.03.23;Belastung LSV;-7.00;88887.10;01.03.23
28.02.23;Belastung LSV;-328.30;88894.10;28.02.23
28.02.23;Verg�tung;-67.30;89222.40;28.02.23
28.02.23;Eft-Pos - Coop Pronto Davos, Davos Dorf - 26.02.2023 14:42 - N. di carta xxxxxxxxxxxx4476 - 7.10 CHF;-7.10;89289.70;26.02.23
24.02.23;Pagamento stipendio Cembra Money Bank AG;6939.00;89296.80;24.02.23
23.02.23;Addebito TWINT SBB EasyRide App 0400001187013633;-6.10;82357.80;23.02.23
23.02.23;Eft-Pos - Restaurant A1 M.O.V.E., Zurich - 21.02.2023 13:10 - N. di carta xxxxxxxxxxxx4476 - 9.50 CHF;-9.50;82363.90;21.02.23
23.02.23;Eft-Pos - Coop-5629 ZH Vulkanstras, Zurich - 21.02.2023 13:29 - N. di carta xxxxxxxxxxxx4476 - 1.40 CHF;-1.40;82373.40;21.02.23
22.02.23;Addebito TWINT SBB EasyRide App 0400001185267772;-6.10;82374.80;22.02.23
22.02.23;Eft-Pos - Restaurant A1 M.O.V.E., Zurich - 20.02.2023 12:29 - N. di carta xxxxxxxxxxxx4476 - 8.50 CHF;-8.50;82380.90;20.02.23
22.02.23;Eft-Pos - Coop-5629 ZH Vulkanstras, Zurich - 20.02.2023 12:46 - N. di carta xxxxxxxxxxxx4476 - 1.40 CHF;-1.40;82389.40;20.02.23
21.02.23;Addebito TWINT SBB EasyRide App 0400001183528115;-6.10;82390.80;21.02.23
21.02.23;Eft-Pos - Lidl Regensdorf, Regensdorf - 17.02.2023 18:51 - N. di carta xxxxxxxxxxxx4476 - 59.30 CHF;-59.30;82396.90;17.02.23
20.02.23;Dauerauftrag;-1090.00;82456.20;20.02.23
20.02.23;Addebito TWINT Ogg The Farmer 0400001179997776;-9.05;83546.20;18.02.23
16.02.23;Eft-Pos - Restaurant A1 M.O.V.E., Zurich - 14.02.2023 12:30 - N. di carta xxxxxxxxxxxx4476 - 9.50 CHF;-9.50;83555.25;14.02.23
15.02.23;Addebito TWINT SBB EasyRide App 0400001173055544;-6.10;83564.75;15.02.23
15.02.23;Eft-Pos - Denner Regensdorf, Regensdorf - 13.02.2023 17:42 - N. di carta xxxxxxxxxxxx4476 - 32.25 CHF;-32.25;83570.85;13.02.23
14.02.23;Belastung LSV;-12.25;83603.10;14.02.23
14.02.23;Eft-Pos - Coop-1506 Regensdorf, Regensdorf - 11.02.2023 17:31 - N. di carta xxxxxxxxxxxx4476 - 38.35 CHF;-38.35;83615.35;11.02.23
14.02.23;Eft-Pos - Lidl Regensdorf, Regensdorf - 11.02.2023 17:58 - N. di carta xxxxxxxxxxxx4476 - 70.60 CHF;-70.60;83653.70;11.02.23
14.02.23;Eft-Pos - Migros MM Regensdorf, Regensdorf - 10.02.2023 19:35 - N. di carta xxxxxxxxxxxx4476 - 23.50 CHF;-23.50;83724.30;10.02.23
14.02.23;Eft-Pos - Muller Handels AG Schwei, Regensdorf - 10.02.2023 19:38 - N. di carta xxxxxxxxxxxx4476 - 2.20 CHF;-2.20;83747.80;10.02.23
10.02.23;Verg�tung;-10.00;83750.00;10.02.23
09.02.23;Eft-Pos - Restaurant A1 M.O.V.E., Zurich - 07.02.2023 12:58 - N. di carta xxxxxxxxxxxx4476 - 8.50 CHF;-8.50;83760.00;07.02.23
08.02.23;Addebito TWINT SBB EasyRide App 0400001160241439;-6.10;83768.50;08.02.23
08.02.23;Eft-Pos - Restaurant A1 M.O.V.E., Zurich - 06.02.2023 13:10 - N. di carta xxxxxxxxxxxx4476 - 8.50 CHF;-8.50;83774.60;06.02.23
08.02.23;Eft-Pos - Coop-5629 ZH Vulkanstras, Zurich - 06.02.2023 13:27 - N. di carta xxxxxxxxxxxx4476 - 1.40 CHF;-1.40;83783.10;06.02.23
07.02.23;Addebito TWINT SBB EasyRide App 0400001158378708;-6.10;83784.50;07.02.23
07.02.23;Eft-Pos - Lidl Regensdorf, Regensdorf - 04.02.2023 18:21 - N. di carta xxxxxxxxxxxx4476 - 23.05 CHF;-23.05;83790.60;04.02.23
07.02.23;Eft-Pos - Coop-2572 Regensdorf/Rag, Regensdorf - 04.02.2023 17:59 - N. di carta xxxxxxxxxxxx4476 - 282.45 CHF;-282.45;83813.65;04.02.23
06.02.23;Zahlungseingang;200.00;84096.10;06.02.23
06.02.23;Addebito TWINT SBB EasyRide App 0400001155292418;-2.30;83896.10;05.02.23
02.02.23;Eft-Pos - Restaurant A1 M.O.V.E., Zurich - 31.01.2023 12:15 - N. di carta xxxxxxxxxxxx4476 - 6.00 CHF;-6.00;83898.40;31.01.23
01.02.23;Addebito TWINT Post CH AG 0400001148290285;-9.25;83904.40;01.02.23
01.02.23;Addebito TWINT SBB EasyRide App 0400001147115385;-6.10;83913.65;01.02.23
01.02.23;Belastung LSV;-7.00;83919.75;01.02.23
31.01.23;Belastung LSV;-328.30;83926.75;31.01.23
31.01.23;Verg�tung;-76.45;84255.05;31.01.23
31.01.23;Eft-Pos - Lidl Regensdorf, Regensdorf - 28.01.2023 17:22 - N. di carta xxxxxxxxxxxx4476 - 161.30 CHF;-161.30;84331.50;28.01.23
30.01.23;Verg�tung;-1000.00;84492.80;30.01.23
30.01.23;Addebito TWINT SBB EasyRide App 0400001139824153;-3.40;85492.80;28.01.23
26.01.23;Addebito TWINT Ogg The Farmer 0400001137017182;-3.00;85496.20;26.01.23
26.01.23;Eft-Pos - Restaurant A1 M.O.V.E., Zurich - 24.01.2023 12:19 - N. di carta xxxxxxxxxxxx4476 - 8.50 CHF;-8.50;85499.20;24.01.23
25.01.23;Addebito TWINT SBB EasyRide App 0400001133234533;-6.10;85507.70;25.01.23
24.01.23;Pagamento stipendio Cembra Money Bank AG;6939.00;85513.80;24.01.23
24.01.23;Eft-Pos - MCDONALDS RESTAURANT, SCHLIEREN - 21.01.2023 11:53 - N. di carta xxxxxxxxxxxx4476 - 37.50 CHF;-37.50;78574.80;21.01.23
20.01.23;Dauerauftrag;-1090.00;78612.30;20.01.23
19.01.23;Addebito TWINT Busson, Christophe, +41792693507 0400001123772829;-7.00;79702.30;19.01.23
19.01.23;Eft-Pos - Restaurant A1 M.O.V.E., Zurich - 17.01.2023 12:09 - N. di carta xxxxxxxxxxxx4476 - 8.50 CHF;-8.50;79709.30;17.01.23
18.01.23;Addebito TWINT SBB EasyRide App 0400001121277239;-6.10;79717.80;18.01.23
18.01.23;Eft-Pos - Restaurant A1 M.O.V.E., Zurich - 16.01.2023 13:10 - N. di carta xxxxxxxxxxxx4476 - 8.50 CHF;-8.50;79723.90;16.01.23
17.01.23;Addebito TWINT SBB EasyRide App 0400001119636825;-6.10;79732.40;17.01.23
17.01.23;Eft-Pos - Migros MM Regensdorf, Regensdorf - 14.01.2023 17:28 - N. di carta xxxxxxxxxxxx4476 - 80.00 CHF;-80.00;79738.50;14.01.23
17.01.23;Eft-Pos - Coop-2572 Regensdorf/Rag, Regensdorf - 13.01.2023 18:27 - N. di carta xxxxxxxxxxxx4476 - 101.35 CHF;-101.35;79818.50;13.01.23
16.01.23;Belastung LSV;-29.30;79919.85;16.01.23
13.01.23;Eft-Pos - Ooki Pavillon AG, Zurich - 11.01.2023 21:05 - N. di carta xxxxxxxxxxxx4476 - 59.00 CHF;-59.00;79949.15;11.01.23
12.01.23;Addebito TWINT SBB EasyRide App 0400001111159053;-6.10;80008.15;12.01.23
12.01.23;Eft-Pos - Coop-5629 ZH Vulkanstras, Zurich - 10.01.2023 13:13 - N. di carta xxxxxxxxxxxx4476 - 1.40 CHF;-1.40;80014.25;10.01.23
12.01.23;Eft-Pos - Restaurant A1 M.O.V.E., Zurich - 10.01.2023 12:58 - N. di carta xxxxxxxxxxxx4476 - 8.50 CHF;-8.50;80015.65;10.01.23
11.01.23;Addebito TWINT SBB EasyRide App 0400001109423053;-6.10;80024.15;11.01.23
11.01.23;Eft-Pos - LA NUOVA SFOGLIATELLA DI, MONTEVARCHI - 07.01.2023 08:30 - N. di carta xxxxxxxxxxxx4476 - 6.80 EUR al tasso di cambio 0.997059 = CHF 6.78 Piu commisioni CHF 1.50;-8.28;80030.25;07.01.23
10.01.23;Eft-Pos - Elvetino AG, Zurich - 07.01.2023 13:25 - N. di carta xxxxxxxxxxxx4476 - 4.90 EUR al tasso di cambio 0.997959 = CHF 4.89;-4.89;80038.53;07.01.23
10.01.23;Eft-Pos - SBB Zugsverkauf, Bern - 07.01.2023 17:37 - N. di carta xxxxxxxxxxxx4476 - 5.00 CHF;-5.00;80043.42;07.01.23
10.01.23;Eft-Pos - Lidl Regensdorf, Regensdorf - 07.01.2023 20:50 - N. di carta xxxxxxxxxxxx4476 - 38.85 CHF;-38.85;80048.42;07.01.23
10.01.23;Eft-Pos - L  ANTICO FORNO, MONTEVARCHI - 07.01.2023 08:38 - N. di carta xxxxxxxxxxxx4476 - 14.60 EUR al tasso di cambio 0.99726 = CHF 14.56 Piu commisioni CHF 1.50;-16.06;80087.27;07.01.23
10.01.23;Eft-Pos - EUROSPIN, MONTEVARCHI - 06.01.2023 11:52 - N. di carta xxxxxxxxxxxx4476 - 59.59 EUR al tasso di cambio 0.997315 = CHF 59.43 Piu commisioni CHF 1.50;-60.93;80103.33;06.01.23
09.01.23;Addebito TWINT Ogg The Farmer 0400001105504080;-6.00;80164.26;08.01.23
09.01.23;Addebito TWINT SBB EasyRide App 0400001104895189;-3.40;80170.26;08.01.23
09.01.23;Eft-Pos - NENCINI SPORT, TERRANUOVA BR - 05.01.2023 20:01 - N. di carta xxxxxxxxxxxx4476 - 266.15 EUR al tasso di cambio 0.999699 = CHF 266.07 Piu commisioni CHF 1.50;-267.57;80173.66;05.01.23
09.01.23;Eft-Pos - MACELLERIA MORETTI, MONTEVARCHI - 05.01.2023 11:40 - N. di carta xxxxxxxxxxxx4476 - 52.47 EUR al tasso di cambio 0.999809 = CHF 52.46 Piu commisioni CHF 1.50;-53.96;80441.23;05.01.23
09.01.23;Eft-Pos - LA NUOVA SFOGLIATELLA DI, MONTEVARCHI - 04.01.2023 10:27 - N. di carta xxxxxxxxxxxx4476 - 8.80 EUR al tasso di cambio 1.001136 = CHF 8.81 Piu commisioni CHF 1.50;-10.31;80495.19;04.01.23
06.01.23;Eft-Pos - NENCINI SPORT, TERRANUOVA BR - 04.01.2023 12:13 - N. di carta xxxxxxxxxxxx4476 - 166.65 EUR al tasso di cambio 1.00072 = CHF 166.77 Piu commisioni CHF 1.50;-168.27;80505.50;04.01.23
05.01.23;Eft-Pos - YAMATOJI, TERRANUOVA BR - 03.01.2023 22:40 - N. di carta xxxxxxxxxxxx4476 - 100.00 EUR al tasso di cambio 0.9994 = CHF 99.94 Piu commisioni CHF 1.50;-101.44;80673.77;03.01.23
04.01.23;Eft-Pos - AGRICOLA SCHEPIS GIUS, SAN GIOVANNI - 02.01.2023 09:49 - N. di carta xxxxxxxxxxxx4476 - 8.60 EUR al tasso di cambio 0.996512 = CHF 8.57 Piu commisioni CHF 1.50;-10.07;80775.21;02.01.23
04.01.23;Eft-Pos - LIDL 638, MONTEVARCHI - 02.01.2023 11:56 - N. di carta xxxxxxxxxxxx4476 - 19.09 EUR al tasso di cambio 0.996857 = CHF 19.03 Piu commisioni CHF 1.50;-20.53;80785.28;02.01.23
04.01.23;Eft-Pos - CONAD, MONTEVARCHI - 02.01.2023 09:42 - N. di carta xxxxxxxxxxxx4476 - 22.16 EUR al tasso di cambio 0.996841 = CHF 22.09 Piu commisioni CHF 1.50;-23.59;80805.81;02.01.23
03.01.23;Belastung LSV;-328.30;80829.40;03.01.23
03.01.23;Eft-Pos - Lego North LGW, London - 01.01.2023 12:46 - N. di carta xxxxxxxxxxxx4476 - 149.58 GBP al tasso di cambio 1.13451 = CHF 169.70 Piu commisioni CHF 1.50;-171.20;81157.70;01.01.23
03.01.23;Eft-Pos - SHAKE SHACK GATWICK 15, GATWICK - 01.01.2023 13:04 - N. di carta xxxxxxxxxxxx4476 - 44.40 GBP al tasso di cambio 1.134459 = CHF 50.37 Piu commisioni CHF 1.50;-51.87;81328.90;01.01.23
03.01.23;Eft-Pos - HAVELOCK TAVERN, BROOK GREEN - 31.12.2022 21:30 - N. di carta xxxxxxxxxxxx4476 - 60.19 GBP al tasso di cambio 1.134574 = CHF 68.29 Piu commisioni CHF 1.50;-69.79;81380.77;31.12.22
03.01.23;Eft-Pos - MASBRO FOOD AND WINE, GREENFORD UB6 - 31.12.2022 21:39 - N. di carta xxxxxxxxxxxx4476 - 3.98 GBP al tasso di cambio 1.135678 = CHF 4.52 Piu commisioni CHF 1.50;-6.02;81450.56;31.12.22
03.01.23;Eft-Pos - Zettle_Streets of Korea, London - 31.12.2022 15:24 - N. di carta xxxxxxxxxxxx4476 - 10.50 GBP al tasso di cambio 1.134286 = CHF 11.91 Piu commisioni CHF 1.50;-13.41;81456.58;31.12.22
03.01.23;Eft-Pos - BOOTS 0745, LONDON - 31.12.2022 14:06 - N. di carta xxxxxxxxxxxx4476 - 7.85 GBP al tasso di cambio 1.135032 = CHF 8.91 Piu commisioni CHF 1.50;-10.41;81469.99;31.12.22
03.01.23;Eft-Pos - ZETTLE_MAZE COLLECTIO, LONDON - 31.12.2022 15:48 - N. di carta xxxxxxxxxxxx4476 - 38.00 GBP al tasso di cambio 1.134474 = CHF 43.11 Piu commisioni CHF 1.50;-44.61;81480.40;31.12.22
03.01.23;Eft-Pos - STARBUCKS, LONDON - 30.12.2022 12:39 - N. di carta xxxxxxxxxxxx4476 - 3.80 GBP al tasso di cambio 1.134211 = CHF 4.31 Piu commisioni CHF 1.50;-5.81;81525.01;30.12.22
03.01.23;Eft-Pos - SHAKE SHACK - VICTORIA, LONDON - 30.12.2022 14:35 - N. di carta xxxxxxxxxxxx4476 - 18.40 GBP al tasso di cambio 1.134783 = CHF 20.88 Piu commisioni CHF 1.50;-22.38;81530.82;30.12.22
03.01.23;Eft-Pos - SHAKE SHACK - VICTORIA, LONDON - 30.12.2022 14:08 - N. di carta xxxxxxxxxxxx4476 - 40.80 GBP al tasso di cambio 1.134559 = CHF 46.29 Piu commisioni CHF 1.50;-47.79;81553.20;30.12.22
03.01.23;Eft-Pos - JAPAN CENTRE GROUP, LONDON  SW1Y - 30.12.2022 16:35 - N. di carta xxxxxxxxxxxx4476 - 6.45 GBP al tasso di cambio 1.134884 = CHF 7.32 Piu commisioni CHF 1.50;-8.82;81600.99;30.12.22
03.01.23;Eft-Pos - JAPAN CENTRE GROUP, LONDON  SW1Y - 30.12.2022 17:18 - N. di carta xxxxxxxxxxxx4476 - 56.35 GBP al tasso di cambio 1.134516 = CHF 63.93 Piu commisioni CHF 1.50;-65.43;81609.81;30.12.22
03.01.23;Eft-Pos - CAFFE NERO 40 PORTCULLIS, LONDON - 30.12.2022 21:04 - N. di carta xxxxxxxxxxxx4476 - 2.95 GBP al tasso di cambio 1.135593 = CHF 3.35 Piu commisioni CHF 1.50;-4.85;81675.24;30.12.22
03.01.23;Eft-Pos - MIKAWA JAPAN W12, LONDON - 29.12.2022 22:16 - N. di carta xxxxxxxxxxxx4476 - 68.40 GBP al tasso di cambio 1.140205 = CHF 77.99 Piu commisioni CHF 1.50;-79.49;81680.09;29.12.22
03.01.23;Eft-Pos - SAINSBURYS S/MKTS, HAMMERSMITH & - 29.12.2022 22:32 - N. di carta xxxxxxxxxxxx4476 - 18.89 GBP al tasso di cambio 1.140286 = CHF 21.54 Piu commisioni CHF 1.50;-23.04;81759.58;29.12.22
03.01.23;Eft-Pos - Glenkeir Whiskies Limite, Glasgow - 29.12.2022 13:26 - N. di carta xxxxxxxxxxxx4476 - 63.00 GBP al tasso di cambio 1.140159 = CHF 71.83 Piu commisioni CHF 1.50;-73.33;81782.62;29.12.22
31.12.22;Zahlungsverkehrsspesen;-2.60;81855.95;31.12.22
30.12.22;Belastung LSV;-7.00;81858.55;30.12.22
29.12.22;Verg�tung;-64.90;81865.55;29.12.22
28.12.22;Eft-Pos - 43040175 COSTA COFFEE, GATWICK - 24.12.2022 18:46 - N. di carta xxxxxxxxxxxx4476 - 7.50 GBP al tasso di cambio 1.142667 = CHF 8.57 Piu commisioni CHF 1.50;-10.07;81930.45;24.12.22
28.12.22;Eft-Pos - Coop-2572 Regensdorf/Rag, Regensdorf - 23.12.2022 16:43 - N. di carta xxxxxxxxxxxx4476 - 141.90 CHF;-141.90;81940.52;23.12.22
27.12.22;Eft-Pos - SUMUP  RAINTOWN BARBERS, REGENSDORF - 22.12.2022 19:16 - N. di carta xxxxxxxxxxxx4476 - 35.00 CHF;-35.00;82082.42;22.12.22
22.12.22;Eft-Pos - C & A Mode Regensdorf /, Regensdorf - 20.12.2022 18:37 - N. di carta xxxxxxxxxxxx4476 - 40.25 CHF;-40.25;82117.42;20.12.22
22.12.22;Eft-Pos - SUMUP  TREGI GMBH, BUNZEN - 20.12.2022 17:59 - N. di carta xxxxxxxxxxxx4476 - 19.40 CHF;-19.40;82157.67;20.12.22
21.12.22;Addebito TWINT Voinova, Tatiana, +41799529190 0400001075853763;-3.00;82177.07;21.12.22
21.12.22;Eft-Pos - Restaurant A1 M.O.V.E., Zurich - 19.12.2022 12:18 - N. di carta xxxxxxxxxxxx4476 - 9.50 CHF;-9.50;82180.07;19.12.22
21.12.22;Eft-Pos - Coop-5629 ZH Vulkanstras, Zurich - 19.12.2022 08:19 - N. di carta xxxxxxxxxxxx4476 - 2.95 CHF;-2.95;82189.57;19.12.22
20.12.22;Addebito TWINT SBB EasyRide App 0400001073259053;-6.10;82192.52;20.12.22
20.12.22;Dauerauftrag;-1090.00;82198.62;20.12.22
20.12.22;Eft-Pos - PASTEL DE NATA, ZUERICH - 17.12.2022 17:40 - N. di carta xxxxxxxxxxxx4476 - 15.00 CHF;-15.00;83288.62;17.12.22
20.12.22;Eft-Pos - BOD DESIGN, BERLIN - 17.12.2022 17:25 - N. di carta xxxxxxxxxxxx4476 - 75.00 CHF Piu commisioni CHF 1.50;-76.50;83303.62;17.12.22
19.12.22;Addebito TWINT SBB EasyRide App 0400001069862860;-6.10;83380.12;18.12.22
16.12.22;Pagamento stipendio Cembra Money Bank AG;6923.05;83386.22;16.12.22
14.12.22;Belastung LSV;-1018.35;76463.17;14.12.22
09.12.22;Eft-Pos - Denner Regensdorf, Regensdorf - 07.12.2022 12:19 - N. di carta xxxxxxxxxxxx4476 - 6.70 CHF;-6.70;77481.52;07.12.22
08.12.22;Eft-Pos - Restaurant A1 M.O.V.E., Zurich - 06.12.2022 12:14 - N. di carta xxxxxxxxxxxx4476 - 6.00 CHF;-6.00;77488.22;06.12.22
07.12.22;Addebito TWINT SBB EasyRide App 0400001048480522;-6.10;77494.22;07.12.22
07.12.22;Eft-Pos - Restaurant A1 M.O.V.E., Zurich - 05.12.2022 13:11 - N. di carta xxxxxxxxxxxx4476 - 8.50 CHF;-8.50;77500.32;05.12.22
06.12.22;Addebito TWINT SBB EasyRide App 0400001046550391;-6.10;77508.82;06.12.22
06.12.22;Eft-Pos - Lidl Regensdorf, Regensdorf - 03.12.2022 17:09 - N. di carta xxxxxxxxxxxx4476 - 182.55 CHF;-182.55;77514.92;03.12.22
05.12.22;Addebito TWINT SBB EasyRide App 0400001041310981;-6.10;77697.47;03.12.22
05.12.22;Addebito TWINT Coop-2572 Regensdorf/R�gi-M�rt 0400001040445958;-58.35;77703.57;03.12.22
02.12.22;Addebito TWINT Ogg The Farmer 0400001040464667;-6.00;77761.92;02.12.22
01.12.22;Belastung LSV;-7.00;77767.92;01.12.22
01.12.22;Eft-Pos - Restaurant A1 M.O.V.E., Zurich - 29.11.2022 12:24 - N. di carta xxxxxxxxxxxx4476 - 9.50 CHF;-9.50;77774.92;29.11.22
30.11.22;Belastung LSV;-313.90;77784.42;30.11.22
30.11.22;Verg�tung;-64.00;78098.32;30.11.22
30.11.22;Addebito TWINT SBB EasyRide App 0400001035079996;-6.10;78162.32;30.11.22
30.11.22;Eft-Pos - Restaurant A1 M.O.V.E., Zurich - 28.11.2022 13:10 - N. di carta xxxxxxxxxxxx4476 - 8.50 CHF;-8.50;78168.42;28.11.22
29.11.22;Addebito TWINT SBB EasyRide App 0400001033224685;-6.10;78176.92;29.11.22
28.11.22;Addebito TWINT Ogg The Farmer 0400001030469528;-13.00;78183.02;27.11.22
24.11.22;Pagamento stipendio Cembra Money Bank AG;6923.05;78196.02;24.11.22
24.11.22;Eft-Pos - Lidl Regensdorf, Regensdorf - 22.11.2022 19:16 - N. di carta xxxxxxxxxxxx4476 - 65.65 CHF;-65.65;71272.97;22.11.22
24.11.22;Eft-Pos - Restaurant A1 M.O.V.E., Zurich - 22.11.2022 12:11 - N. di carta xxxxxxxxxxxx4476 - 8.50 CHF;-8.50;71338.62;22.11.22
22.11.22;Eft-Pos - Lidl Regensdorf, Regensdorf - 19.11.2022 17:36 - N. di carta xxxxxxxxxxxx4476 - 18.40 CHF;-18.40;71347.12;19.11.22
21.11.22;Addebito TWINT Ogg The Farmer 0400001015589819;-30.50;71365.52;19.11.22
21.11.22;Addebito TWINT Ogg The Farmer 0400001015571592;-6.00;71396.02;19.11.22
18.11.22;Dauerauftrag;-1090.00;71402.02;18.11.22
17.11.22;Eft-Pos - Restaurant A1 M.O.V.E., Zurich - 15.11.2022 12:14 - N. di carta xxxxxxxxxxxx4476 - 8.50 CHF;-8.50;72492.02;15.11.22
17.11.22;Eft-Pos - Denner Regensdorf, Regensdorf - 15.11.2022 18:12 - N. di carta xxxxxxxxxxxx4476 - 33.10 CHF;-33.10;72500.52;15.11.22
17.11.22;Eft-Pos - Denner Regensdorf, Regensdorf - 15.11.2022 18:17 - N. di carta xxxxxxxxxxxx4476 - 5.95 CHF;-5.95;72533.62;15.11.22
16.11.22;Verg�tung;-699.00;72539.57;16.11.22
15.11.22;Eft-Pos - JUMBO-2017 Regensdorf, Regensdorf - 12.11.2022 14:49 - N. di carta xxxxxxxxxxxx4476 - 14.00 CHF;-14.00;73238.57;12.11.22
15.11.22;Eft-Pos - WERKK Kulturlokal, Baden - 11.11.2022 22:18 - N. di carta xxxxxxxxxxxx4476 - 20.00 CHF;-20.00;73252.57;11.11.22
14.11.22;Addebito TWINT Ogg The Farmer 0400001003536282;-6.00;73272.57;12.11.22
10.11.22;Eft-Pos - Lidl Regensdorf, Regensdorf - 08.11.2022 18:25 - N. di carta xxxxxxxxxxxx4476 - 56.05 CHF;-56.05;73278.57;08.11.22
10.11.22;Eft-Pos - Restaurant A1 M.O.V.E., Zurich - 08.11.2022 12:29 - N. di carta xxxxxxxxxxxx4476 - 9.50 CHF;-9.50;73334.62;08.11.22
09.11.22;Eft-Pos - Restaurant A1 M.O.V.E., Zurich - 07.11.2022 13:02 - N. di carta xxxxxxxxxxxx4476 - 8.50 CHF;-8.50;73344.12;07.11.22
08.11.22;Eft-Pos - LANDI Regensdorf Genosse, Adlikon B.Reg - 05.11.2022 15:58 - N. di carta xxxxxxxxxxxx4476 - 17.10 CHF;-17.10;73352.62;05.11.22
08.11.22;Eft-Pos - Lidl Regensdorf, Regensdorf - 04.11.2022 18:11 - N. di carta xxxxxxxxxxxx4476 - 30.75 CHF;-30.75;73369.72;04.11.22
04.11.22;Belastung LSV;-7.00;73400.47;04.11.22
03.11.22;Eft-Pos - Restaurant A1 M.O.V.E., Zurich - 01.11.2022 12:15 - N. di carta xxxxxxxxxxxx4476 - 8.50 CHF;-8.50;73407.47;01.11.22
03.11.22;Accredito - Thermalquellen Brigerbad, Brigerbad - 30.10.2022 00:00 - N. di carta xxxxxxxxxxxx4476 - 273.10 CHF;273.10;73415.97;30.10.22
03.11.22;Accredito - Aletsch Riederalp Bahnen, Morel - 29.10.2022 00:00 - N. di carta xxxxxxxxxxxx4476 - 29.40 CHF;29.40;73142.87;29.10.22
02.11.22;Verg�tung;-170.90;73113.47;02.11.22
02.11.22;Eft-Pos - Lidl Regensdorf, Regensdorf - 31.10.2022 18:56 - N. di carta xxxxxxxxxxxx4476 - 3.90 CHF;-3.90;73284.37;31.10.22
02.11.22;Eft-Pos - Lidl Regensdorf, Regensdorf - 31.10.2022 18:51 - N. di carta xxxxxxxxxxxx4476 - 41.50 CHF;-41.50;73288.27;31.10.22
02.11.22;Eft-Pos - Restaurant A1 M.O.V.E., Zurich - 31.10.2022 13:04 - N. di carta xxxxxxxxxxxx4476 - 6.00 CHF;-6.00;73329.77;31.10.22
01.11.22;Eft-Pos - Thermalquellen Brigerbad, Brigerbad - 30.10.2022 09:38 - N. di carta xxxxxxxxxxxx4476 - 273.10 CHF;-273.10;73335.77;30.10.22
01.11.22;Eft-Pos - Thermalquellen Brigerbad, Brigerbad - 30.10.2022 09:38 - N. di carta xxxxxxxxxxxx4476 - 273.10 CHF;-273.10;73608.87;30.10.22
01.11.22;Eft-Pos - LAC SOUTERRAIN DE ST L, ST LEONARD - 30.10.2022 11:33 - N. di carta xxxxxxxxxxxx4476 - 8.00 CHF;-8.00;73881.97;30.10.22
01.11.22;Eft-Pos - Aletsch Riederalp Bahnen, Morel - 29.10.2022 11:02 - N. di carta xxxxxxxxxxxx4476 - 29.40 CHF;-29.40;73889.97;29.10.22
01.11.22;Eft-Pos - Restaurant Belalp, Naters - 29.10.2022 19:54 - N. di carta xxxxxxxxxxxx4476 - 103.50 CHF;-103.50;73919.37;29.10.22
01.11.22;Eft-Pos - Aletsch Riederalp Bahnen, Morel - 29.10.2022 11:02 - N. di carta xxxxxxxxxxxx4476 - 29.40 CHF;-29.40;74022.87;29.10.22
01.11.22;Eft-Pos - MCDONALDS AMACKER, BRIG - 28.10.2022 14:19 - N. di carta xxxxxxxxxxxx4476 - 42.70 CHF;-42.70;74052.27;28.10.22
01.11.22;Eft-Pos - Thermalquellen Brigerbad, Brigerbad - 28.10.2022 11:13 - N. di carta xxxxxxxxxxxx4476 - 1.50 CHF;-1.50;74094.97;28.10.22
01.11.22;Eft-Pos - Thermalquellen Brigerbad, Brigerbad - 28.10.2022 11:23 - N. di carta xxxxxxxxxxxx4476 - 70.00 CHF;-70.00;74096.47;28.10.22
31.10.22;Verg�tung;-64.00;74166.47;31.10.22
31.10.22;Belastung LSV;-313.90;74230.47;31.10.22
31.10.22;Addebito TWINT , Marons, +41793567073 0400000980513497;-7.00;74544.37;30.10.22
27.10.22;Verg�tung;-1000.00;74551.37;27.10.22
27.10.22;Eft-Pos - Restaurant A1 M.O.V.E., Zurich - 25.10.2022 12:46 - N. di carta xxxxxxxxxxxx4476 - 8.50 CHF;-8.50;75551.37;25.10.22
26.10.22;Eft-Pos - Restaurant A1 M.O.V.E., Zurich - 24.10.2022 13:07 - N. di carta xxxxxxxxxxxx4476 - 9.50 CHF;-9.50;75559.87;24.10.22
25.10.22;Eft-Pos - SUMUP  GASTRO NEW LIFE, MAGGIA - 23.10.2022 11:23 - N. di carta xxxxxxxxxxxx4476 - 14.00 CHF;-14.00;75569.37;23.10.22
25.10.22;Eft-Pos - Camping TCS Bella Riva, Gordevio - 23.10.2022 11:05 - N. di carta xxxxxxxxxxxx4476 - 15.00 CHF;-15.00;75583.37;23.10.22
25.10.22;Eft-Pos - Lidl Regensdorf, Regensdorf - 21.10.2022 18:17 - N. di carta xxxxxxxxxxxx4476 - 85.55 CHF;-85.55;75598.37;21.10.22
24.10.22;Pagamento stipendio Cembra Money Bank AG;7922.85;75683.92;24.10.22
20.10.22;Dauerauftrag;-1090.00;67761.07;20.10.22
20.10.22;Eft-Pos - Restaurant A1 M.O.V.E., Zurich - 18.10.2022 12:57 - N. di carta xxxxxxxxxxxx4476 - 8.50 CHF;-8.50;68851.07;18.10.22
19.10.22;Eft-Pos - Buffet Express - HB Zuri, Zurich - 17.10.2022 16:37 - N. di carta xxxxxxxxxxxx4476 - 4.40 CHF;-4.40;68859.57;17.10.22
19.10.22;Eft-Pos - Restaurant A1 M.O.V.E., Zurich - 17.10.2022 12:36 - N. di carta xxxxxxxxxxxx4476 - 9.50 CHF;-9.50;68863.97;17.10.22
18.10.22;Eft-Pos - Lidl Regensdorf, Regensdorf - 14.10.2022 18:08 - N. di carta xxxxxxxxxxxx4476 - 71.70 CHF;-71.70;68873.47;14.10.22
17.10.22;Addebito TWINT Ogg The Farmer 0400000956376052;-9.50;68945.17;15.10.22
14.10.22;Belastung LSV;-56.60;68954.67;14.10.22
14.10.22;Eft-Pos - El Lokal AG, Zurich - 12.10.2022 19:58 - N. di carta xxxxxxxxxxxx4476 - 17.30 CHF;-17.30;69011.27;12.10.22
14.10.22;Eft-Pos - Coop-5609 ZH Andreasturm, Zurich - 12.10.2022 13:42 - N. di carta xxxxxxxxxxxx4476 - 2.50 CHF;-2.50;69028.57;12.10.22
13.10.22;Eft-Pos - Restaurant A1 M.O.V.E., Zurich - 11.10.2022 12:09 - N. di carta xxxxxxxxxxxx4476 - 8.50 CHF;-8.50;69031.07;11.10.22
12.10.22;Eft-Pos - Restaurant A1 M.O.V.E., Zurich - 10.10.2022 13:03 - N. di carta xxxxxxxxxxxx4476 - 8.50 CHF;-8.50;69039.57;10.10.22
11.10.22;Eft-Pos - Denner Regensdorf, Regensdorf - 08.10.2022 15:50 - N. di carta xxxxxxxxxxxx4476 - 16.40 CHF;-16.40;69048.07;08.10.22
11.10.22;Eft-Pos - C & A Mode Regensdorf /, Regensdorf - 08.10.2022 15:07 - N. di carta xxxxxxxxxxxx4476 - 29.95 CHF;-29.95;69064.47;08.10.22
11.10.22;Eft-Pos - Lidl Regensdorf, Regensdorf - 07.10.2022 19:58 - N. di carta xxxxxxxxxxxx4476 - 75.45 CHF;-75.45;69094.42;07.10.22
10.10.22;Addebito TWINT Ogg The Farmer 0400000945768989;-8.50;69169.87;08.10.22
10.10.22;Storno Eft-Pos - Restaurant A1 M.O.V.E., Zurich - 03.10.2022 12:38 - N. di carta xxxxxxxxxxxx4476 - 9.50 CHF;9.50;69178.37;03.10.22
10.10.22;Storno Eft-Pos - Selecta AG / PuV, Kirchberg BE - 02.10.2022 16:08 - N. di carta xxxxxxxxxxxx4476 - 3.80 CHF;3.80;69168.87;02.10.22
10.10.22;Storno Eft-Pos - Musee H.-R. Giger, Gruyeres - 02.10.2022 12:08 - N. di carta xxxxxxxxxxxx4476 - 29.00 CHF;29.00;69165.07;02.10.22
10.10.22;Storno Eft-Pos - Burger King Rothrist, Rothrist - 02.10.2022 19:34 - N. di carta xxxxxxxxxxxx4476 - 55.20 CHF;55.20;69136.07;02.10.22
10.10.22;Storno Eft-Pos - Bahnhofkiosk, Fribourg - 02.10.2022 15:57 - N. di carta xxxxxxxxxxxx4476 - 8.25 CHF;8.25;69080.87;02.10.22
10.10.22;Storno Eft-Pos - Lidl Regensdorf, Regensdorf - 01.10.2022 12:17 - N. di carta xxxxxxxxxxxx4476 - 48.25 CHF;48.25;69072.62;01.10.22
07.10.22;Eft-Pos - Restaurant A1 M.O.V.E., Zurich - 03.10.2022 12:38 - N. di carta xxxxxxxxxxxx4476 - 9.50 CHF;-9.50;69024.37;03.10.22
07.10.22;Eft-Pos - Restaurant A1 M.O.V.E., Zurich - 03.10.2022 12:38 - N. di carta xxxxxxxxxxxx4476 - 9.50 CHF;-9.50;69033.87;03.10.22
07.10.22;Eft-Pos - Selecta AG / PuV, Kirchberg BE - 02.10.2022 16:08 - N. di carta xxxxxxxxxxxx4476 - 3.80 CHF;-3.80;69043.37;02.10.22
07.10.22;Eft-Pos - Musee H.-R. Giger, Gruyeres - 02.10.2022 12:08 - N. di carta xxxxxxxxxxxx4476 - 29.00 CHF;-29.00;69047.17;02.10.22
07.10.22;Eft-Pos - Burger King Rothrist, Rothrist - 02.10.2022 19:34 - N. di carta xxxxxxxxxxxx4476 - 55.20 CHF;-55.20;69076.17;02.10.22
07.10.22;Eft-Pos - Bahnhofkiosk, Fribourg - 02.10.2022 15:57 - N. di carta xxxxxxxxxxxx4476 - 8.25 CHF;-8.25;69131.37;02.10.22
07.10.22;Eft-Pos - Selecta AG / PuV, Kirchberg BE - 02.10.2022 16:08 - N. di carta xxxxxxxxxxxx4476 - 3.80 CHF;-3.80;69139.62;02.10.22
07.10.22;Eft-Pos - Musee H.-R. Giger, Gruyeres - 02.10.2022 12:08 - N. di carta xxxxxxxxxxxx4476 - 29.00 CHF;-29.00;69143.42;02.10.22
07.10.22;Eft-Pos - Burger King Rothrist, Rothrist - 02.10.2022 19:34 - N. di carta xxxxxxxxxxxx4476 - 55.20 CHF;-55.20;69172.42;02.10.22
07.10.22;Eft-Pos - Bahnhofkiosk, Fribourg - 02.10.2022 15:57 - N. di carta xxxxxxxxxxxx4476 - 8.25 CHF;-8.25;69227.62;02.10.22
07.10.22;Eft-Pos - Lidl Regensdorf, Regensdorf - 01.10.2022 12:17 - N. di carta xxxxxxxxxxxx4476 - 48.25 CHF;-48.25;69235.87;01.10.22
07.10.22;Eft-Pos - Lidl Regensdorf, Regensdorf - 01.10.2022 12:17 - N. di carta xxxxxxxxxxxx4476 - 48.25 CHF;-48.25;69284.12;01.10.22
06.10.22;Eft-Pos - Restaurant A1 M.O.V.E., Zurich - 04.10.2022 13:07 - N. di carta xxxxxxxxxxxx4476 - 8.50 CHF;-8.50;69332.37;04.10.22
03.10.22;Belastung LSV;-7.00;69340.87;03.10.22
30.09.22;Belastung LSV;-313.90;69347.87;30.09.22
30.09.22;Verg�tung;-65.35;69661.77;30.09.22
29.09.22;Verg�tung;-1000.00;69727.12;29.09.22
29.09.22;Eft-Pos - Coop-5629 ZH Vulkanstras, Zurich - 27.09.2022 08:08 - N. di carta xxxxxxxxxxxx4476 - 2.95 CHF;-2.95;70727.12;27.09.22
29.09.22;Eft-Pos - Restaurant A1 M.O.V.E., Zurich - 27.09.2022 11:48 - N. di carta xxxxxxxxxxxx4476 - 6.00 CHF;-6.00;70730.07;27.09.22
28.09.22;Eft-Pos - Restaurant A1 M.O.V.E., Zurich - 26.09.2022 12:25 - N. di carta xxxxxxxxxxxx4476 - 8.50 CHF;-8.50;70736.07;26.09.22
23.09.22;Pagamento stipendio Cembra Money Bank AG;6428.70;70744.57;23.09.22
22.09.22;Verg�tung;-5000.00;64315.87;22.09.22
22.09.22;Eft-Pos - Restaurant A1 M.O.V.E., Zurich - 20.09.2022 12:39 - N. di carta xxxxxxxxxxxx4476 - 8.50 CHF;-8.50;69315.87;20.09.22
21.09.22;Eft-Pos - Restaurant A1 M.O.V.E., Zurich - 19.09.2022 13:00 - N. di carta xxxxxxxxxxxx4476 - 9.50 CHF;-9.50;69324.37;19.09.22
20.09.22;Eft-Pos - DELLEA DIEGO, DUMENZA - 16.09.2022 22:36 - N. di carta xxxxxxxxxxxx4476 - 35.50 EUR al tasso di cambio 0.971831 = CHF 34.50 Piu commisioni CHF 1.50;-36.00;69333.87;16.09.22
15.09.22;Eft-Pos - Restaurant A1 M.O.V.E., Zurich - 13.09.2022 11:44 - N. di carta xxxxxxxxxxxx4476 - 9.50 CHF;-9.50;69369.87;13.09.22
14.09.22;Belastung LSV;-264.95;69379.37;14.09.22
12.09.22;Verg�tung;-1000.00;69644.32;12.09.22
12.09.22;Addebito TWINT Coop-1506 Regensdorf 0400000900273288;-141.30;70644.32;11.09.22
12.09.22;Addebito TWINT Regensdorf , Porchetta, +41763261562 0400000900225537;-22.00;70785.62;10.09.22
09.09.22;Addebito TWINT Sivantham, Giritharan, +41789443126 0400000897368315;-15.00;70807.62;09.09.22
08.09.22;Eft-Pos - Coop-5629 ZH Vulkanstras, Zurich - 06.09.2022 12:28 - N. di carta xxxxxxxxxxxx4476 - 8.35 CHF;-8.35;70822.62;06.09.22
07.09.22;Eft-Pos - Restaurant A1 M.O.V.E., Zurich - 05.09.2022 13:13 - N. di carta xxxxxxxxxxxx4476 - 6.00 CHF;-6.00;70830.97;05.09.22
06.09.22;Eft-Pos - SUMUP  KIOSK KATZENSEE, ZURICH - 04.09.2022 14:25 - N. di carta xxxxxxxxxxxx4476 - 11.00 CHF;-11.00;70836.97;04.09.22
05.09.22;Addebito TWINT Seeholz Beizli 0400000888010271;-8.00;70847.97;04.09.22
05.09.22;Addebito TWINT Ogg The Farmer 0400000887700313;-3.00;70855.97;04.09.22
01.09.22;Belastung LSV;-7.00;70858.97;01.09.22
01.09.22;Eft-Pos - Restaurant A1 M.O.V.E., Zurich - 30.08.2022 13:01 - N. di carta xxxxxxxxxxxx4476 - 6.00 CHF;-6.00;70865.97;30.08.22
01.09.22;Eft-Pos - Coop-5629 ZH Vulkanstras, Zurich - 30.08.2022 12:48 - N. di carta xxxxxxxxxxxx4476 - 1.40 CHF;-1.40;70871.97;30.08.22
31.08.22;Dauerauftrag;-1090.00;70873.37;31.08.22
31.08.22;Belastung LSV;-313.90;71963.37;31.08.22
31.08.22;Verg�tung;-64.25;72277.27;31.08.22
31.08.22;Eft-Pos - Restaurant A1 M.O.V.E., Zurich - 29.08.2022 13:26 - N. di carta xxxxxxxxxxxx4476 - 6.00 CHF;-6.00;72341.52;29.08.22
30.08.22;Verg�tung;-1090.00;72347.52;30.08.22
25.08.22;Eft-Pos - Restaurant A1 M.O.V.E., Zurich - 23.08.2022 13:11 - N. di carta xxxxxxxxxxxx4476 - 9.50 CHF;-9.50;73437.52;23.08.22
25.08.22;Eft-Pos - Coop-5629 ZH Vulkanstras, Zurich - 23.08.2022 13:24 - N. di carta xxxxxxxxxxxx4476 - 1.40 CHF;-1.40;73447.02;23.08.22
24.08.22;Pagamento stipendio Cembra Money Bank AG;6593.05;73448.42;24.08.22
24.08.22;Eft-Pos - Restaurant A1 M.O.V.E., Zurich - 22.08.2022 13:28 - N. di carta xxxxxxxxxxxx4476 - 8.50 CHF;-8.50;66855.37;22.08.22
23.08.22;Eft-Pos - Lidl Regensdorf, Regensdorf - 20.08.2022 15:40 - N. di carta xxxxxxxxxxxx4476 - 64.15 CHF;-64.15;66863.87;20.08.22
23.08.22;Eft-Pos - Coop-2572 Regensdorf/Rag, Regensdorf - 19.08.2022 18:44 - N. di carta xxxxxxxxxxxx4476 - 87.85 CHF;-87.85;66928.02;19.08.22
23.08.22;Eft-Pos - LA TAPENADE A PHL, PHILADELPHIA - 19.08.2022 00:28 - N. di carta xxxxxxxxxxxx4476 - 4.19 USD al tasso di cambio 0.966587 = CHF 4.05 Piu commisioni CHF 1.50;-5.55;67015.87;19.08.22
23.08.22;Eft-Pos - EMC SEAFOOD & RAW BAR, 213-3519988 - 15.08.2022 07:21 - N. di carta xxxxxxxxxxxx4476 - 114.00 USD al tasso di cambio 0.969737 = CHF 110.55 Piu commisioni CHF 1.50;-112.05;67021.42;15.08.22
22.08.22;Eft-Pos - IN N OUT BURGER 102, HOLLYWOOD - 17.08.2022 22:22 - N. di carta xxxxxxxxxxxx4476 - 18.01 USD al tasso di cambio 0.96613 = CHF 17.40 Piu commisioni CHF 1.50;-18.90;67133.47;17.08.22
19.08.22;Eft-Pos - SINACO OIL CORP, LOS ANGELES - 18.08.2022 02:41 - N. di carta xxxxxxxxxxxx4476 - 2.99 USD al tasso di cambio 0.9699 = CHF 2.90 Piu commisioni CHF 1.50;-4.40;67152.37;18.08.22
19.08.22;Eft-Pos - LA CITY METERED PARKING, LOS ANGELES - 17.08.2022 02:01 - N. di carta xxxxxxxxxxxx4476 - 2.00 USD al tasso di cambio 0.975 = CHF 1.95 Piu commisioni CHF 1.50;-3.45;67156.77;17.08.22
19.08.22;Eft-Pos - CHRIS N EDDYS, LOS ANGELES - 17.08.2022 07:41 - N. di carta xxxxxxxxxxxx4476 - 9.86 USD al tasso di cambio 0.963489 = CHF 9.50 Piu commisioni CHF 1.50;-11.00;67160.22;17.08.22
19.08.22;Eft-Pos - HOLLYWOOD AND HIGHLAND, LOS ANGELES - 16.08.2022 09:39 - N. di carta xxxxxxxxxxxx4476 - 3.00 USD al tasso di cambio 0.966667 = CHF 2.90 Piu commisioni CHF 1.50;-4.40;67171.22;16.08.22
19.08.22;Eft-Pos - CINNABON 904, UNIVERSAL CIT - 16.08.2022 18:14 - N. di carta xxxxxxxxxxxx4476 - 10.38 USD al tasso di cambio 0.963391 = CHF 10.00 Piu commisioni CHF 1.50;-11.50;67175.62;16.08.22
18.08.22;Eft-Pos - HOGSMEAD STATION, UNIVERSAL CIT - 17.08.2022 00:20 - N. di carta xxxxxxxxxxxx4476 - 10.95 USD al tasso di cambio 0.958904 = CHF 10.50 Piu commisioni CHF 1.50;-12.00;67187.12;17.08.22
18.08.22;Eft-Pos - POPEYES 2157, HOLLYWOOD - 17.08.2022 03:30 - N. di carta xxxxxxxxxxxx4476 - 13.34 USD al tasso di cambio 0.95952 = CHF 12.80 Piu commisioni CHF 1.50;-14.30;67199.12;17.08.22
18.08.22;Eft-Pos - KRUSTY BURGER, UNIVERSAL CIT - 16.08.2022 20:59 - N. di carta xxxxxxxxxxxx4476 - 35.84 USD al tasso di cambio 0.961217 = CHF 34.45 Piu commisioni CHF 1.50;-35.95;67213.42;16.08.22
18.08.22;Eft-Pos - USH PARKING RC, UNIVERSAL CIT - 16.08.2022 18:03 - N. di carta xxxxxxxxxxxx4476 - 30.00 USD al tasso di cambio 0.961667 = CHF 28.85 Piu commisioni CHF 1.50;-30.35;67249.37;16.08.22
18.08.22;Eft-Pos - WACKO, LOS ANGELES - 16.08.2022 01:14 - N. di carta xxxxxxxxxxxx4476 - 29.55 USD al tasso di cambio 0.961083 = CHF 28.40 Piu commisioni CHF 1.50;-29.90;67279.72;16.08.22
18.08.22;Eft-Pos - CHINESE THEATRES BAR AND, LOS ANGELES - 16.08.2022 06:55 - N. di carta xxxxxxxxxxxx4476 - 13.00 USD al tasso di cambio 0.961538 = CHF 12.50 Piu commisioni CHF 1.50;-14.00;67309.62;16.08.22
18.08.22;Eft-Pos - JACK IN THE BOX 5455, LOS ANGELES - 16.08.2022 09:54 - N. di carta xxxxxxxxxxxx4476 - 2.95 USD al tasso di cambio 0.966102 = CHF 2.85 Piu commisioni CHF 1.50;-4.35;67323.62;16.08.22
18.08.22;Eft-Pos - SLAB, LOS ANGELES - 16.08.2022 04:35 - N. di carta xxxxxxxxxxxx4476 - 77.78 USD al tasso di cambio 0.961044 = CHF 74.75 Piu commisioni CHF 1.50;-76.25;67327.97;16.08.22
18.08.22;Eft-Pos - TOMMYS 1, LOS ANGELES - 15.08.2022 20:31 - N. di carta xxxxxxxxxxxx4476 - 12.15 USD al tasso di cambio 0.962963 = CHF 11.70 Piu commisioni CHF 1.50;-13.20;67404.22;15.08.22
18.08.22;Eft-Pos - FOOT LOCKER - 08059, LOS ANGELES - 15.08.2022 23:08 - N. di carta xxxxxxxxxxxx4476 - 60.23 USD al tasso di cambio 0.961315 = CHF 57.90 Piu commisioni CHF 1.50;-59.40;67417.42;15.08.22
17.08.22;Eft-Pos - HOLLYSHORTS, WWW.HOLLYWOOD - 16.08.2022 06:52 - N. di carta xxxxxxxxxxxx4476 - 44.00 USD al tasso di cambio 0.956818 = CHF 42.10 Piu commisioni CHF 1.50;-43.60;67476.82;16.08.22
17.08.22;Eft-Pos - IN N OUT BURGER 292, CABAZON - 14.08.2022 21:13 - N. di carta xxxxxxxxxxxx4476 - 20.10 USD al tasso di cambio 0.955224 = CHF 19.20 Piu commisioni CHF 1.50;-20.70;67520.42;14.08.22
17.08.22;Eft-Pos - TST Roadrunner Grab & G, JOSHUA TREE - 14.08.2022 19:55 - N. di carta xxxxxxxxxxxx4476 - 11.98 USD al tasso di cambio 0.95576 = CHF 11.45 Piu commisioni CHF 1.50;-12.95;67541.12;14.08.22
16.08.22;Eft-Pos - PEGGY SUES 50S DINER, YERMO - 14.08.2022 01:12 - N. di carta xxxxxxxxxxxx4476 - 45.02 USD al tasso di cambio 0.955131 = CHF 43.00 Piu commisioni CHF 1.50;-44.50;67554.07;14.08.22
16.08.22;Eft-Pos - CIRCLE K 00770, MORONGO VALLE - 14.08.2022 20:39 - N. di carta xxxxxxxxxxxx4476 - 33.67 USD al tasso di cambio 0.954856 = CHF 32.15 Piu commisioni CHF 1.50;-33.65;67598.57;14.08.22
16.08.22;Eft-Pos - JAKES SALOON, LONE PINE - 13.08.2022 05:54 - N. di carta xxxxxxxxxxxx4476 - 16.00 USD al tasso di cambio 0.953125 = CHF 15.25 Piu commisioni CHF 1.50;-16.75;67632.22;13.08.22
16.08.22;Eft-Pos - TEXACO 0306011, JOHANNESBURG - 13.08.2022 22:36 - N. di carta xxxxxxxxxxxx4476 - 3.90 USD al tasso di cambio 0.948718 = CHF 3.70 Piu commisioni CHF 1.50;-5.20;67648.97;13.08.22
16.08.22;Eft-Pos - EXXONMOBIL    96517040, OLANCHA - 13.08.2022 21:11 - N. di carta xxxxxxxxxxxx4476 - 6.49 USD al tasso di cambio 0.955316 = CHF 6.20 Piu commisioni CHF 1.50;-7.70;67654.17;13.08.22
15.08.22;Belastung LSV;-544.45;67661.87;15.08.22
09.08.22;Eft-Pos - IN N OUT BURGER 222, SAN LEANDRO - 06.08.2022 00:45 - N. di carta xxxxxxxxxxxx4476 - 15.78 USD al tasso di cambio 0.97275 = CHF 15.35 Piu commisioni CHF 1.50;-16.85;68206.32;06.08.22
09.08.22;Eft-Pos - GUYS CORNER, MADISON - 06.08.2022 03:14 - N. di carta xxxxxxxxxxxx4476 - 26.53 USD al tasso di cambio 0.974369 = CHF 25.85 Piu commisioni CHF 1.50;-27.35;68223.17;06.08.22
09.08.22;Eft-Pos - IN N OUT BURGER 137, REDDING - 06.08.2022 20:25 - N. di carta xxxxxxxxxxxx4476 - 10.40 USD al tasso di cambio 0.975962 = CHF 10.15 Piu commisioni CHF 1.50;-11.65;68250.52;06.08.22
09.08.22;Eft-Pos - TARGET        00006155, REDDING - 06.08.2022 20:14 - N. di carta xxxxxxxxxxxx4476 - 24.56 USD al tasso di cambio 0.973127 = CHF 23.90 Piu commisioni CHF 1.50;-25.40;68262.17;06.08.22
09.08.22;Eft-Pos - FOODMAXX 476 RED B, RED BLUFF - 06.08.2022 06:19 - N. di carta xxxxxxxxxxxx4476 - 36.85 USD al tasso di cambio 0.972863 = CHF 35.85 Piu commisioni CHF 1.50;-37.35;68287.57;06.08.22
09.08.22;Eft-Pos - TST Woodhouse Fish Co -, San Francisco - 05.08.2022 02:07 - N. di carta xxxxxxxxxxxx4476 - 99.60 USD al tasso di cambio 0.973394 = CHF 96.95 Piu commisioni CHF 1.50;-98.45;68324.92;05.08.22
09.08.22;Eft-Pos - PORK STORE., SAN FRANCISCO - 05.08.2022 18:46 - N. di carta xxxxxxxxxxxx4476 - 43.31 USD al tasso di cambio 0.973216 = CHF 42.15 Piu commisioni CHF 1.50;-43.65;68423.37;05.08.22
09.08.22;Eft-Pos - CHESTNUT DINER, SAN FRANCISCO - 04.08.2022 19:33 - N. di carta xxxxxxxxxxxx4476 - 16.78 USD al tasso di cambio 0.974374 = CHF 16.35 Piu commisioni CHF 1.50;-17.85;68467.02;04.08.22
08.08.22;Verg�tung;-5000.00;68484.87;08.08.22
08.08.22;Eft-Pos - SQ HINODEYA RAMEN DOWNT, San Francisco - 05.08.2022 05:01 - N. di carta xxxxxxxxxxxx4476 - 33.37 USD al tasso di cambio 0.973929 = CHF 32.50 Piu commisioni CHF 1.50;-34.00;73484.87;05.08.22
08.08.22;Eft-Pos - SQ HING LUNG COMPA, SAN FRANCISCO - 04.08.2022 21:21 - N. di carta xxxxxxxxxxxx4476 - 13.30 USD al tasso di cambio 0.973684 = CHF 12.95 Piu commisioni CHF 1.50;-14.45;73518.87;04.08.22
08.08.22;Eft-Pos - SANTA CRUZ COFFEE ROASTI, WATSONVILLE - 03.08.2022 21:15 - N. di carta xxxxxxxxxxxx4476 - 5.35 USD al tasso di cambio 0.971963 = CHF 5.20 Piu commisioni CHF 1.50;-6.70;73533.32;03.08.22
05.08.22;Eft-Pos - JACKS HAMBURGERS, SANTA CRUZ - 03.08.2022 22:23 - N. di carta xxxxxxxxxxxx4476 - 24.36 USD al tasso di cambio 0.974959 = CHF 23.75 Piu commisioni CHF 1.50;-25.25;73540.02;03.08.22
05.08.22;Eft-Pos - BOOKSHOP SANTA CRUZ, SANTA CRUZ - 03.08.2022 21:47 - N. di carta xxxxxxxxxxxx4476 - 63.15 USD al tasso di cambio 0.975455 = CHF 61.60 Piu commisioni CHF 1.50;-63.10;73565.27;03.08.22
05.08.22;Prelievo Bancomat - 106 CHURCH ST, SANTA CRUZ - 03.08.2022 21:52 - N. di carta xxxxxxxxxxxx4476 - 103.00 USD al tasso di cambio 0.975243 = CHF 100.45 Piu commisioni CHF 5.00;-105.45;73628.37;03.08.22
05.08.22;Eft-Pos - FRANKIE & LOLAS FRONT ST, MORRO BAY - 02.08.2022 19:29 - N. di carta xxxxxxxxxxxx4476 - 36.18 USD al tasso di cambio 0.975677 = CHF 35.30 Piu commisioni CHF 1.50;-36.80;73733.82;02.08.22
04.08.22;Eft-Pos - CAMP ONE - MORRO, MORRO BAY - 02.08.2022 19:57 - N. di carta xxxxxxxxxxxx4476 - 69.58 USD al tasso di cambio 0.965795 = CHF 67.20 Piu commisioni CHF 1.50;-68.70;73770.62;02.08.22
04.08.22;Eft-Pos - HARBOR HUT, MORRO BAY - 02.08.2022 06:33 - N. di carta xxxxxxxxxxxx4476 - 137.60 USD al tasso di cambio 0.965843 = CHF 132.90 Piu commisioni CHF 1.50;-134.40;73839.32;02.08.22
04.08.22;Eft-Pos - REI 134 SANTA BARBARA, SANTA BARBARA - 01.08.2022 20:20 - N. di carta xxxxxxxxxxxx4476 - 108.63 USD al tasso di cambio 0.965663 = CHF 104.90 Piu commisioni CHF 1.50;-106.40;73973.72;01.08.22
04.08.22;Eft-Pos - IN N OUT BURGER 108, GOLETA - 01.08.2022 21:46 - N. di carta xxxxxxxxxxxx4476 - 20.10 USD al tasso di cambio 0.965174 = CHF 19.40 Piu commisioni CHF 1.50;-20.90;74080.12;01.08.22
03.08.22;Eft-Pos - IN N OUT BURGER 076, VENTURA - 01.08.2022 06:03 - N. di carta xxxxxxxxxxxx4476 - 12.61 USD al tasso di cambio 0.963521 = CHF 12.15 Piu commisioni CHF 1.50;-13.65;74101.02;01.08.22
03.08.22;Eft-Pos - SANTA BARBARA GAS, SANTA BARBARA - 01.08.2022 21:20 - N. di carta xxxxxxxxxxxx4476 - 151.03 USD al tasso di cambio 0.963716 = CHF 145.55 Piu commisioni CHF 1.50;-147.05;74114.67;01.08.22
03.08.22;Eft-Pos - TST The Apple Pan, Los Angeles - 31.07.2022 20:53 - N. di carta xxxxxxxxxxxx4476 - 3.29 USD al tasso di cambio 0.957447 = CHF 3.15 Piu commisioni CHF 1.50;-4.65;74261.72;31.07.22
03.08.22;Eft-Pos - TST The Apple Pan, Los Angeles - 31.07.2022 20:47 - N. di carta xxxxxxxxxxxx4476 - 43.88 USD al tasso di cambio 0.963993 = CHF 42.30 Piu commisioni CHF 1.50;-43.80;74266.37;31.07.22
03.08.22;Eft-Pos - ROBERT H MEYER MEMORIAL, MALIBU - 31.07.2022 00:00 - N. di carta xxxxxxxxxxxx4476 - 3.00 USD al tasso di cambio 0.966667 = CHF 2.90 Piu commisioni CHF 1.50;-4.40;74310.17;31.07.22
03.08.22;Eft-Pos - VONS 2096, VENTURA - 31.07.2022 00:00 - N. di carta xxxxxxxxxxxx4476 - 90.55 USD al tasso di cambio 0.963556 = CHF 87.25 Piu commisioni CHF 1.50;-88.75;74314.57;31.07.22
03.08.22;Eft-Pos - IN N OUT BURGER 119, LOS ANGELES - 31.07.2022 22:44 - N. di carta xxxxxxxxxxxx4476 - 12.65 USD al tasso di cambio 0.964427 = CHF 12.20 Piu commisioni CHF 1.50;-13.70;74403.32;31.07.22
03.08.22;Eft-Pos - STARBUCKS STORE 05494, LOS ANGELES - 31.07.2022 22:30 - N. di carta xxxxxxxxxxxx4476 - 5.75 USD al tasso di cambio 0.965217 = CHF 5.55 Piu commisioni CHF 1.50;-7.05;74417.02;31.07.22
02.08.22;Belastung LSV;-313.90;74424.07;02.08.22
02.08.22;Belastung LSV;-7.00;74737.97;02.08.22
02.08.22;Eft-Pos - SQ CINESPIA BARS, Hollywood - 31.07.2022 06:04 - N. di carta xxxxxxxxxxxx4476 - 22.00 USD al tasso di cambio 0.975 = CHF 21.45 Piu commisioni CHF 1.50;-22.95;74744.97;31.07.22
02.08.22;Eft-Pos - TST Bludsos Bar and Que, Los Angeles - 31.07.2022 05:42 - N. di carta xxxxxxxxxxxx4476 - 65.70 USD al tasso di cambio 0.975647 = CHF 64.10 Piu commisioni CHF 1.50;-65.60;74767.92;31.07.22
02.08.22;Eft-Pos - WHOLEFDS WWD 10176, LOS ANGELES - 31.07.2022 22:18 - N. di carta xxxxxxxxxxxx4476 - 25.64 USD al tasso di cambio 0.975039 = CHF 25.00 Piu commisioni CHF 1.50;-26.50;74833.52;31.07.22
02.08.22;Prelievo Bancomat - 603 N FAIRFAX AVE, LOS ANGELES - 31.07.2022 04:23 - N. di carta xxxxxxxxxxxx4476 - 45.77 CHF Piu commisioni CHF 5.00;-50.75;74860.02;31.07.22
02.08.22;Prelievo Bancomat - 603 N FAIRFAX AVE, LOS ANGELES - 31.07.2022 20:04 - N. di carta xxxxxxxxxxxx4476 - 102.99 USD al tasso di cambio 0.975823 = CHF 100.50 Piu commisioni CHF 5.00;-105.50;74910.77;31.07.22
02.08.22;Eft-Pos - HOLIDAY MOTEL, SANTA MONICA - 30.07.2022 18:52 - N. di carta xxxxxxxxxxxx4476 - 20.00 USD al tasso di cambio 0.975 = CHF 19.50 Piu commisioni CHF 1.50;-21.00;75016.27;30.07.22
02.08.22;Eft-Pos - TST MELS DRIVE IN - SA, SANTA MONICA - 30.07.2022 20:05 - N. di carta xxxxxxxxxxxx4476 - 45.61 USD al tasso di cambio 0.975663 = CHF 44.50 Piu commisioni CHF 1.50;-46.00;75037.27;30.07.22
02.08.22;Eft-Pos - BUBBA GUMP SANTA MONIC, SANTA MONICA - 30.07.2022 22:25 - N. di carta xxxxxxxxxxxx4476 - 28.93 USD al tasso di cambio 0.976495 = CHF 28.25 Piu commisioni CHF 1.50;-29.75;75083.27;30.07.22
02.08.22;Eft-Pos - TAXI SVC LOS ANGELES, LOS ANGELES - 30.07.2022 09:26 - N. di carta xxxxxxxxxxxx4476 - 25.00 USD al tasso di cambio 0.976 = CHF 24.40 Piu commisioni CHF 1.50;-25.90;75113.02;30.07.22
02.08.22;Eft-Pos - SQ THE MOSAIC TILE, VENICE - 30.07.2022 16:30 - N. di carta xxxxxxxxxxxx4476 - 41.28 USD al tasso di cambio 0.97626 = CHF 40.30 Piu commisioni CHF 1.50;-41.80;75138.92;30.07.22
02.08.22;Eft-Pos - A.I.R. Restaurant, Zurich - 29.07.2022 09:27 - N. di carta xxxxxxxxxxxx4476 - 17.80 CHF;-17.80;75180.72;29.07.22
02.08.22;Eft-Pos - GENOS STEAKS, PHILADELPHIA - 29.07.2022 22:09 - N. di carta xxxxxxxxxxxx4476 - 13.23 USD al tasso di cambio 0.975057 = CHF 12.90 Piu commisioni CHF 1.50;-14.40;75198.52;29.07.22
29.07.22;Dauerauftrag;-1090.00;75212.92;29.07.22
29.07.22;Verg�tung;-71.10;76302.92;29.07.22
29.07.22;Eft-Pos - Denner Regensdorf, Regensdorf - 27.07.2022 13:28 - N. di carta xxxxxxxxxxxx4476 - 17.00 CHF;-17.00;76374.02;27.07.22
29.07.22;Eft-Pos - Lidl Regensdorf, Regensdorf - 27.07.2022 13:23 - N. di carta xxxxxxxxxxxx4476 - 35.95 CHF;-35.95;76391.02;27.07.22
28.07.22;Eft-Pos - Restaurant A1 M.O.V.E., Zurich - 26.07.2022 12:07 - N. di carta xxxxxxxxxxxx4476 - 9.50 CHF;-9.50;76426.97;26.07.22
27.07.22;Verg�tung;-165.00;76436.47;27.07.22
27.07.22;Eft-Pos - Restaurant A1 M.O.V.E., Zurich - 25.07.2022 12:10 - N. di carta xxxxxxxxxxxx4476 - 8.50 CHF;-8.50;76601.47;25.07.22
27.07.22;Eft-Pos - Coop-5629 ZH Vulkanstras, Zurich - 25.07.2022 12:44 - N. di carta xxxxxxxxxxxx4476 - 2.95 CHF;-2.95;76609.97;25.07.22
22.07.22;Pagamento stipendio Cembra Money Bank AG;6593.05;76612.92;22.07.22
22.07.22;Eft-Pos - Migros M Hauptbahnhof Zu, Zurich - 20.07.2022 15:07 - N. di carta xxxxxxxxxxxx4476 - 5.55 CHF;-5.55;70019.87;20.07.22
15.07.22;Belastung LSV;-7.00;70025.42;15.07.22
14.07.22;Belastung LSV;-49.90;70032.42;14.07.22
14.07.22;Eft-Pos - Restaurant A1 M.O.V.E., Zurich - 12.07.2022 12:26 - N. di carta xxxxxxxxxxxx4476 - 8.50 CHF;-8.50;70082.32;12.07.22
13.07.22;Eft-Pos - Restaurant A1 M.O.V.E., Zurich - 11.07.2022 12:28 - N. di carta xxxxxxxxxxxx4476 - 6.00 CHF;-6.00;70090.82;11.07.22
07.07.22;Eft-Pos - Restaurant A1 M.O.V.E., Zurich - 05.07.2022 13:38 - N. di carta xxxxxxxxxxxx4476 - 9.50 CHF;-9.50;70096.82;05.07.22
06.07.22;Eft-Pos - Restaurant A1 M.O.V.E., Zurich - 04.07.2022 12:23 - N. di carta xxxxxxxxxxxx4476 - 6.00 CHF;-6.00;70106.32;04.07.22
05.07.22;Eft-Pos - Migros MM Regensdorf, Regensdorf - 01.07.2022 19:43 - N. di carta xxxxxxxxxxxx4476 - 66.45 CHF;-66.45;70112.32;01.07.22
05.07.22;Eft-Pos - Muller Handels AG Schwei, Regensdorf - 01.07.2022 19:08 - N. di carta xxxxxxxxxxxx4476 - 36.90 CHF;-36.90;70178.77;01.07.22
05.07.22;Eft-Pos - Lidl Regensdorf, Regensdorf - 01.07.2022 20:23 - N. di carta xxxxxxxxxxxx4476 - 74.30 CHF;-74.30;70215.67;01.07.22
30.06.22;Dauerauftrag;-1090.00;70289.97;30.06.22
30.06.22;Belastung LSV;-313.90;71379.97;30.06.22
30.06.22;Belastung LSV;-345.60;71693.87;30.06.22
30.06.22;Verg�tung;-61.70;72039.47;30.06.22
30.06.22;Eft-Pos - Coop-5629 ZH Vulkanstras, Zurich - 28.06.2022 13:49 - N. di carta xxxxxxxxxxxx4476 - 3.90 CHF;-3.90;72101.17;28.06.22
30.06.22;Eft-Pos - Restaurant A1 M.O.V.E., Zurich - 28.06.2022 13:35 - N. di carta xxxxxxxxxxxx4476 - 8.50 CHF;-8.50;72105.07;28.06.22
29.06.22;Eft-Pos - WH SMITH, GATWICK - 27.06.2022 17:25 - N. di carta xxxxxxxxxxxx4476 - 6.50 GBP al tasso di cambio 1.2 = CHF 7.80 Piu commisioni CHF 1.50;-9.30;72113.57;27.06.22
29.06.22;Eft-Pos - SHAKE SHACK COVENT GAR, WATFORD - 27.06.2022 14:26 - N. di carta xxxxxxxxxxxx4476 - 29.25 GBP al tasso di cambio 1.198291 = CHF 35.05 Piu commisioni CHF 1.50;-36.55;72122.87;27.06.22
29.06.22;Eft-Pos - LONDON OVERGROUND SST, DALSTON KINGS - 27.06.2022 12:00 - N. di carta xxxxxxxxxxxx4476 - 10.00 GBP al tasso di cambio 1.2 = CHF 12.00 Piu commisioni CHF 1.50;-13.50;72159.42;27.06.22
29.06.22;Eft-Pos - IZ PARADOX DESIGN, LONDON - 26.06.2022 15:11 - N. di carta xxxxxxxxxxxx4476 - 8.20 GBP al tasso di cambio 1.20122 = CHF 9.85 Piu commisioni CHF 1.50;-11.35;72172.92;26.06.22
29.06.22;Eft-Pos - BEIGEL BAKE, LONDON  E1 6 - 26.06.2022 13:16 - N. di carta xxxxxxxxxxxx4476 - 9.30 GBP al tasso di cambio 1.198925 = CHF 11.15 Piu commisioni CHF 1.50;-12.65;72184.27;26.06.22
29.06.22;Eft-Pos - TESCO STORES 6248, LONDON - 26.06.2022 14:18 - N. di carta xxxxxxxxxxxx4476 - 5.05 GBP al tasso di cambio 1.19802 = CHF 6.05 Piu commisioni CHF 1.50;-7.55;72196.92;26.06.22
29.06.22;Eft-Pos - ZTLWICKED FISH LTD, London - 26.06.2022 19:54 - N. di carta xxxxxxxxxxxx4476 - 14.00 GBP al tasso di cambio 1.2 = CHF 16.80 Piu commisioni CHF 1.50;-18.30;72204.47;26.06.22
29.06.22;Eft-Pos - RED HAND, LONDON - 26.06.2022 01:09 - N. di carta xxxxxxxxxxxx4476 - 14.60 GBP al tasso di cambio 1.19863 = CHF 17.50 Piu commisioni CHF 1.50;-19.00;72222.77;26.06.22
29.06.22;Eft-Pos - LUL TICKET MACHINE, LIVERPOOL STR - 26.06.2022 00:57 - N. di carta xxxxxxxxxxxx4476 - 10.00 GBP al tasso di cambio 1.2 = CHF 12.00 Piu commisioni CHF 1.50;-13.50;72241.77;26.06.22
27.06.22;Eft-Pos - C & A Mode Regensdorf /, Regensdorf - 23.06.2022 18:15 - N. di carta xxxxxxxxxxxx4476 - 19.95 CHF;-19.95;72255.27;23.06.22
24.06.22;Pagamento stipendio Cembra Money Bank AG;6553.25;72275.22;24.06.22
23.06.22;Addebito TWINT Ogg The Farmer 0400000778315575;-9.50;65721.97;23.06.22
22.06.22;Eft-Pos Restaurant A1 M.O.V. 21.06.2022 11:44 Carta:  61853201  CHF  6.00;-6.00;65731.47;21.06.22
21.06.22;Eft-Pos Restaurant A1 M.O.V. 20.06.2022 12:35 Carta:  61853201  CHF  8.50;-8.50;65737.47;20.06.22
17.06.22;Verg�tung;-120.00;65745.97;17.06.22
17.06.22;Verg�tung;-15.00;65865.97;17.06.22
15.06.22;Eft-Pos Coop-5629 ZH Vulkans 14.06.2022 13:15 Carta:  61853201  CHF  1.40;-1.40;65880.97;14.06.22
15.06.22;Eft-Pos Restaurant A1 M.O.V. 14.06.2022 12:55 Carta:  61853201  CHF  8.50;-8.50;65882.37;14.06.22
14.06.22;Belastung LSV;-276.35;65890.87;14.06.22
14.06.22;Eft-Pos Restaurant A1 M.O.V. 13.06.2022 12:45 Carta:  61853201  CHF  8.50;-8.50;66167.22;13.06.22
08.06.22;Eft-Pos LANDI Regensdorf Gen 07.06.2022 18:52 Carta:  61853201  CHF  19.35;-19.35;66175.72;07.06.22
08.06.22;Eft-Pos Coop-2017 Regensdorf 07.06.2022 18:28 Carta:  61853201  CHF  7.90;-7.90;66195.07;07.06.22
07.06.22;Verg�tung;-1000.00;66202.97;07.06.22
07.06.22;Eft-Pos Lidl Regensdorf      03.06.2022 18:04 Carta:  61853201  CHF  75.75;-75.75;67202.97;03.06.22
07.06.22;Eft-Pos Lidl Regensdorf      02.06.2022 19:22 Carta:  61853201  CHF  71.60;-71.60;67278.72;02.06.22
01.06.22;Eft-Pos Restaurant A1 M.O.V. 31.05.2022 13:12 Carta:  61853201  CHF  6.00;-6.00;67350.32;31.05.22
31.05.22;Addebito TWINT Ogg The Farmer 0400000744344321;-9.50;67356.32;31.05.22
31.05.22;Belastung LSV;-313.90;67365.82;31.05.22
31.05.22;Verg�tung;-58.45;67679.72;31.05.22
31.05.22;Eft-Pos Coop-5629 ZH Vulkans 30.05.2022 14:12 Carta:  61853201  CHF  9.75;-9.75;67738.17;30.05.22
30.05.22;Verg�tung;-800.00;67747.92;30.05.22
30.05.22;Eft-Pos IPERAL DISTRIBUTORE  27.05.2022 17:39 Carta:  61853201;-44.30;68547.92;27.05.22
25.05.22;Eft-Pos Restaurant A1 M.O.V. 24.05.2022 12:27 Carta:  61853201  CHF  9.50;-9.50;68592.22;24.05.22
24.05.22;Pagamento stipendio Cembra Money Bank AG;6632.85;68601.72;24.05.22
24.05.22;Eft-Pos Restaurant A1 M.O.V. 23.05.2022 12:10 Carta:  61853201  CHF  8.50;-8.50;61968.87;23.05.22
24.05.22;Eft-Pos Coop-5629 ZH Vulkans 23.05.2022 14:47 Carta:  61853201  CHF  1.65;-1.65;61977.37;23.05.22
18.05.22;Eft-Pos Restaurant A1 M.O.V. 17.05.2022 12:55 Carta:  61853201  CHF  9.50;-9.50;61979.02;17.05.22
17.05.22;Eft-Pos Coop-5629 ZH Vulkans 16.05.2022 12:46 Carta:  61853201  CHF  4.80;-4.80;61988.52;16.05.22
16.05.22;Belastung LSV;-6.80;61993.32;16.05.22
16.05.22;Verg�tung;-1000.00;62000.12;16.05.22
16.05.22;Addebito TWINT OZ BOWLING GmbH 0400000719783146;-259.00;63000.12;16.05.22
13.05.22;Eft-Pos LANDI Regensdorf Gen 12.05.2022 18:01 Carta:  61853201  CHF  15.00;-15.00;63259.12;12.05.22
11.05.22;Addebito TWINT Ogg The Farmer 0400000714760139;-3.00;63274.12;11.05.22
11.05.22;Addebito TWINT Ogg The Farmer 0400000714757202;-6.60;63277.12;11.05.22
11.05.22;Eft-Pos Restaurant A1 M.O.V. 10.05.2022 12:21 Carta:  61853201  CHF  8.50;-8.50;63283.72;10.05.22
11.05.22;Eft-Pos Moser's Schlossbergp 09.05.2022 18:26 Carta:  61853201  CHF  16.30;-16.30;63292.22;09.05.22
10.05.22;Addebito TWINT Ogg The Farmer 0400000712551863;-9.35;63308.52;10.05.22
09.05.22;Addebito TWINT Berghof 0400000710768101;-4.50;63317.87;09.05.22
06.05.22;Prelevamento al Bancomat BM Zentrum 8105 Regensdorf 06.05.2022 17:28 Carta: 61853201   ;-100.00;63322.37;06.05.22
04.05.22;Eft-Pos Coop-5629 ZH Vulkans 03.05.2022 12:18 Carta:  61853201  CHF  8.35;-8.35;63422.37;03.05.22
03.05.22;Addebito TWINT Ogg The Farmer 0400000703512487;-5.50;63430.72;03.05.22
02.05.22;Belastung LSV;-313.90;63436.22;02.05.22
02.05.22;Belastung LSV;-77.10;63750.12;02.05.22
02.05.22;Belastung LSV;-7.00;63827.22;02.05.22
02.05.22;Verg�tung;-84.25;63834.22;02.05.22
02.05.22;Eft-Pos LANDI Regensdorf Gen 30.04.2022 16:39 Carta:  61853201  CHF  286.75;-286.75;63918.47;30.04.22
02.05.22;Eft-Pos Lidl Regensdorf      29.04.2022 17:21 Carta:  61853201  CHF  164.85;-164.85;64205.22;29.04.22
29.04.22;Addebito TWINT Ogg The Farmer 0400000697649180;-5.50;64370.07;29.04.22
29.04.22;Zahlungseingang;4062.10;64375.57;29.04.22
28.04.22;Eft-Pos Coop-2572 Regensdorf 27.04.2022 12:38 Carta:  61853201  CHF  65.10;-65.10;60313.47;27.04.22
14.04.22;Belastung LSV;-13.10;60378.57;14.04.22
14.04.22;Verg�tung;-18.00;60391.67;14.04.22
13.04.22;Addebito TWINT Ogg The Farmer 0400000677172971;-5.50;60409.67;13.04.22
11.04.22;Eft-Pos MM Regensdorf, Zentr 09.04.2022 18:00 Carta:  61853201  CHF  8.95;-8.95;60415.17;09.04.22
11.04.22;Eft-Pos MM Regensdorf, Zentr 09.04.2022 17:57 Carta:  61853201  CHF  79.15;-79.15;60424.12;09.04.22
11.04.22;Eft-Pos Coop-1506 Regensdorf 09.04.2022 17:14 Carta:  61853201  CHF  38.15;-38.15;60503.27;09.04.22
06.04.22;Belastung LSV;-7.00;60541.42;06.04.22
05.04.22;Addebito TWINT Ogg The Farmer 0400000665955082;-8.50;60548.42;05.04.22
04.04.22;Eft-Pos MM Regensdorf, Zentr 02.04.2022 17:09 Carta:  61853201  CHF  84.95;-84.95;60556.92;02.04.22
04.04.22;Eft-Pos AKSA FOOD HONGG AG   01.04.2022 17:41 Carta:  61853201  CHF  26.50;-26.50;60641.87;01.04.22
31.03.22;Belastung LSV;-313.90;60668.37;31.03.22
31.03.22;Verg�tung;-58.35;60982.27;31.03.22
31.03.22;Eft-Pos LANDI Regensdorf Gen 30.03.2022 16:45 Carta:  61853201  CHF  25.50;-25.50;61040.62;30.03.22
30.03.22;Eft-Pos Lidl Regensdorf      28.03.2022 19:17 Carta:  61853201  CHF  55.15;-55.15;61066.12;28.03.22
28.03.22;Verg�tung;-500.00;61121.27;28.03.22
28.03.22;Storno Eft-Pos Lidl Regensdorf      25.03.2022 11:26 Carta:  61853201  CHF  74.50;74.50;61621.27;25.03.22
28.03.22;Eft-Pos Lidl Regensdorf      25.03.2022 11:26 Carta:  61853201  CHF  74.50;-74.50;61546.77;25.03.22
28.03.22;Eft-Pos Post CH AG (8364) Re 25.03.2022 17:46 Carta:  61853201  CHF  19.00;-19.00;61621.27;25.03.22
28.03.22;Eft-Pos MM Regensdorf, Zentr 25.03.2022 18:03 Carta:  61853201  CHF  25.50;-25.50;61640.27;25.03.22
28.03.22;Eft-Pos Lidl Regensdorf      25.03.2022 11:26 Carta:  61853201  CHF  74.50;-74.50;61665.77;25.03.22
25.03.22;Eft-Pos SumUp  *Kiosk Katzen 23.03.2022 16:33 Carta:  61853201  CHF  2.50;-2.50;61740.27;23.03.22
24.03.22;Zahlungseingang;4392.85;61742.77;24.03.22
24.03.22;Eft-Pos Volg Laden Watt      23.03.2022 17:19 Carta:  61853201  CHF  7.85;-7.85;57349.92;23.03.22
23.03.22;Addebito TWINT Ogg The Farmer 0400000647308760;-5.50;57357.77;23.03.22
22.03.22;Verg�tung;-1000.00;57363.27;22.03.22
21.03.22;Addebito TWINT Bundesamt f�r Justiz 0400000644431034;-20.00;58363.27;21.03.22
21.03.22;Addebito TWINT C&A Regensdorf (055) 0400000642628762;-165.65;58383.27;21.03.22
21.03.22;Addebito TWINT Migros Regensdorf 0400000642652768;-59.65;58548.92;21.03.22
21.03.22;Eft-Pos MM Regensdorf, Zentr 18.03.2022 18:50 Carta:  61853201  CHF  43.40;-43.40;58608.57;18.03.22
21.03.22;Eft-Pos Coop-1506 Regensdorf 18.03.2022 19:03 Carta:  61853201  CHF  16.95;-16.95;58651.97;18.03.22
21.03.22;Eft-Pos Lidl Regensdorf      18.03.2022 19:42 Carta:  61853201  CHF  41.50;-41.50;58668.92;18.03.22
21.03.22;Eft-Pos AKSA FOOD HONGG AG   17.03.2022 18:43 Carta:  61853201  CHF  10.05;-10.05;58710.42;17.03.22
18.03.22;Eft-Pos migrolino Z�rich Aff 17.03.2022 19:10 Carta:  61853201  CHF  3.60;-3.60;58720.47;17.03.22
15.03.22;Eft-Pos BENNET               13.03.2022 20:02 Carta:  61853201;-193.30;58724.07;13.03.22
14.03.22;Belastung LSV;-13.90;58917.37;14.03.22
01.03.22;Belastung LSV;-162.60;58931.27;01.03.22
01.03.22;Belastung LSV;-313.90;59093.87;01.03.22
01.03.22;Belastung LSV;-7.00;59407.77;01.03.22
28.02.22;Verg�tung;-58.05;59414.77;28.02.22
25.02.22;Zahlungseingang;3887.65;59472.82;25.02.22
25.02.22;Verg�tung;-1200.00;55585.17;25.02.22
25.02.22;Addebito TWINT CH, Anna, +41766855541 0400000613278074;-600.00;56785.17;25.02.22
25.02.22;Eft-Pos Lidl Regensdorf      23.02.2022 15:37 Carta:  61853201  CHF  43.00;-43.00;57385.17;23.02.22
24.02.22;Addebito TWINT Asia Store GmbH  0400000612516526;-13.70;57428.17;24.02.22
21.02.22;Addebito TWINT Ogg The Farmer 0400000608204187;-11.50;57441.87;21.02.22
21.02.22;Addebito TWINT Migros Regensdorf 0400000607281192;-112.15;57453.37;21.02.22
17.02.22;Eft-Pos Lidl Regensdorf      15.02.2022 18:23 Carta:  61853201  CHF  68.50;-68.50;57565.52;15.02.22
15.02.22;Addebito TWINT Ogg The Farmer 0400000602782876;-5.50;57634.02;15.02.22
14.02.22;Belastung LSV;-9.70;57639.52;14.02.22
14.02.22;Eft-Pos DD Z�rich Schwamendi 12.02.2022 17:21 Carta:  61853201  CHF  46.90;-46.90;57649.22;12.02.22
14.02.22;Eft-Pos MM Z�rich-Oerlikon   12.02.2022 18:09 Carta:  61853201  CHF  95.80;-95.80;57696.12;12.02.22
14.02.22;Eft-Pos Asiaway AG           12.02.2022 16:14 Carta:  61853201  CHF  2.65;-2.65;57791.92;12.02.22
10.02.22;Addebito TWINT Migros Regensdorf 0400000595793148;-12.70;57794.57;10.02.22
10.02.22;Addebito TWINT Ogg The Farmer 0400000596932451;-5.50;57807.27;10.02.22
07.02.22;Addebito TWINT Coop-1506 Regensdorf 0400000591376258;-27.40;57812.77;07.02.22
07.02.22;Addebito TWINT Migros Regensdorf 0400000591360067;-75.70;57840.17;07.02.22
07.02.22;Addebito TWINT interdiscount.ch 0400000591396574;-904.00;57915.87;07.02.22
07.02.22;Eft-Pos Lidl Regensdorf      04.02.2022 11:46 Carta:  61853201  CHF  41.70;-41.70;58819.87;04.02.22
04.02.22;Eft-Pos Lidl Regensdorf      02.02.2022 18:22 Carta:  61853201  CHF  54.65;-54.65;58861.57;02.02.22
03.02.22;Addebito TWINT Ogg The Farmer 0400000588881725;-6.00;58916.22;03.02.22
01.02.22;Belastung LSV;-313.90;58922.22;01.02.22
01.02.22;Belastung LSV;-7.00;59236.12;01.02.22
31.01.22;Verg�tung;-60.55;59243.12;31.01.22
31.01.22;Addebito TWINT Coop-1839 Buchs (ZH) 0400000583149721;-129.35;59303.67;31.01.22
31.01.22;Eft-Pos New Asia Market      28.01.2022 17:21 Carta:  61853201  CHF  51.50;-51.50;59433.02;28.01.22
28.01.22;Prelevamento al Bancomat BM Altstetterstrasse 145  8048 Z�rich 28.01.2022 17:48 Carta: 61853201   ;-1300.00;59484.52;28.01.22
28.01.22;Verg�tung;-600.00;60784.52;28.01.22
27.01.22;Addebito TWINT Ogg The Farmer 0400000580405385;-7.00;61384.52;27.01.22
26.01.22;Eft-Pos Lidl Regensdorf      24.01.2022 11:08 Carta:  61853201  CHF  55.70;-55.70;61391.52;24.01.22
25.01.22;Zahlungseingang;4062.10;61447.22;25.01.22
24.01.22;Eft-Pos MM Regensdorf, Zentr 22.01.2022 16:16 Carta:  61853201  CHF  100.55;-100.55;57385.12;22.01.22
20.01.22;Zahlungseingang;200.00;57485.67;20.01.22
18.01.22;Addebito TWINT Ogg The Farmer 0400000570145306;-7.00;57285.67;18.01.22
18.01.22;Eft-Pos TopPharm Zentrums-Ap 17.01.2022 10:49 Carta:  61853201  CHF  72.35;-72.35;57292.67;17.01.22
18.01.22;Eft-Pos Coop-1506 Regensdorf 17.01.2022 18:41 Carta:  61853201  CHF  35.05;-35.05;57365.02;17.01.22
17.01.22;Addebito TWINT Cafe Fortuna 0400000567870838;-26.00;57400.07;17.01.22
17.01.22;Eft-Pos MM Regensdorf, Zentr 15.01.2022 17:51 Carta:  61853201  CHF  185.15;-185.15;57426.07;15.01.22
17.01.22;Eft-Pos Zentrum Regensdorf   15.01.2022 18:05 Carta:  61853201  CHF  0.50;-0.50;57611.22;15.01.22
17.01.22;Eft-Pos DD 8105 REGENSDORF   15.01.2022 18:00 Carta:  61853201  CHF  9.95;-9.95;57611.72;15.01.22
17.01.22;Eft-Pos Dosenbach Schuhe & S 14.01.2022 17:02 Carta:  61853201  CHF  35.05;-35.05;57621.67;14.01.22
14.01.22;Belastung LSV;-60.55;57656.72;14.01.22
13.01.22;Eft-Pos Lidl Regensdorf      11.01.2022 18:18 Carta:  61853201  CHF  24.80;-24.80;57717.27;11.01.22
11.01.22;Addebito TWINT Ogg The Farmer 0400000562723474;-7.00;57742.07;11.01.22
10.01.22;Spesen f�r Papierdokument(e);-1.50;57749.07;10.01.22
10.01.22;Eft-Pos Coop-1506 Regensdorf 08.01.2022 14:46 Carta:  61853201  CHF  30.60;-30.60;57750.57;08.01.22
10.01.22;Eft-Pos Lidl Regensdorf      06.01.2022 18:34 Carta:  61853201  CHF  59.00;-59.00;57781.17;06.01.22
07.01.22;Addebito TWINT Coop-1506 Regensdorf 0400000558709382;-96.85;57840.17;07.01.22
04.01.22;Eft-Pos MM Regensdorf, Zentr 03.01.2022 18:46 Carta:  61853201  CHF  98.05;-98.05;57937.02;03.01.22
03.01.22;Belastung LSV;-14.00;58035.07;03.01.22
03.01.22;Eft-Pos SOCAR Tankstelle     31.12.2021 19:36 Carta:  61853201  CHF  77.35;-77.35;58049.07;31.12.21
31.12.21;Zahlungsverkehrsspesen;-3.80;58126.42;31.12.21
31.12.21;Belastung LSV;-313.90;58130.22;31.12.21
31.12.21;Verg�tung;-58.50;58444.12;31.12.21
30.12.21;Eft-Pos Coop-2572 Regensdorf 29.12.2021 17:41 Carta:  61853201  CHF  14.75;-14.75;58502.62;29.12.21
28.12.21;Verg�tung;-400.00;58517.37;28.12.21
27.12.21;Addebito TWINT Migros Regensdorf 0400000547160874;-233.70;58917.37;27.12.21
27.12.21;Eft-Pos Coop TS Regensdorf   24.12.2021 11:34 Carta:  61853201  CHF  34.85;-34.85;59151.07;24.12.21
27.12.21;Eft-Pos MM Regensdorf, Zentr 24.12.2021 13:56 Carta:  61853201  CHF  181.45;-181.45;59185.92;24.12.21
27.12.21;Eft-Pos Zentrum Regensdorf   24.12.2021 14:00 Carta:  61853201  CHF  0.50;-0.50;59367.37;24.12.21
27.12.21;Eft-Pos AKSA FOOD HONGG AG   24.12.2021 12:24 Carta:  61853201  CHF  55.70;-55.70;59367.87;24.12.21
27.12.21;Eft-Pos KINO ABATON          23.12.2021 21:04 Carta:  61853201  CHF  21.50;-21.50;59423.57;23.12.21
24.12.21;Eft-Pos Volg Laden Watt      23.12.2021 15:20 Carta:  61853201  CHF  9.20;-9.20;59445.07;23.12.21
24.12.21;Eft-Pos Lidl Regensdorf      22.12.2021 19:48 Carta:  61853201  CHF  68.00;-68.00;59454.27;22.12.21
23.12.21;Eft-Pos Rigi Bahnen AG       22.12.2021 18:25 Carta:  61853201  CHF  11.00;-11.00;59522.27;22.12.21
23.12.21;Eft-Pos Rigi Bahnen AG       22.12.2021 11:09 Carta:  61853201  CHF  80.00;-80.00;59533.27;22.12.21
22.12.21;Addebito TWINT Ogg The Farmer 0400000542674643;-13.45;59613.27;22.12.21
22.12.21;Addebito TWINT Parkingpay 0400000541276614;-3.00;59626.72;22.12.21
21.12.21;Addebito TWINT , Chocolate, +41782332263 0400000541206306;-15.00;59629.72;21.12.21
21.12.21;Eft-Pos Coop-2623 City SM    19.12.2021 16:43 Carta:  61853201  CHF  113.75;-113.75;59644.72;19.12.21
21.12.21;Eft-Pos Coop-2624 City WH    19.12.2021 16:49 Carta:  61853201  CHF  19.95;-19.95;59758.47;19.12.21
20.12.21;Eft-Pos IKEA AG, Spreitenbac 17.12.2021 20:08 Carta:  61853201  CHF  6.90;-6.90;59778.42;17.12.21
20.12.21;Eft-Pos Lidl Regensdorf      17.12.2021 13:15 Carta:  61853201  CHF  77.40;-77.40;59785.32;17.12.21
16.12.21;Zahlungseingang;4392.85;59862.72;16.12.21
15.12.21;Eft-Pos Aldi Suisse 79       14.12.2021 19:15 Carta:  61853201  CHF  58.15;-58.15;55469.87;14.12.21
14.12.21;Belastung LSV;-57.25;55528.02;14.12.21
14.12.21;Eft-Pos LANDI Regensdorf Gen 13.12.2021 15:07 Carta:  61853201  CHF  12.45;-12.45;55585.27;13.12.21
14.12.21;Eft-Pos Coop-2017 Regensdorf 13.12.2021 15:23 Carta:  61853201  CHF  3.40;-3.40;55597.72;13.12.21
14.12.21;Eft-Pos Lidl Regensdorf      11.12.2021 18:21 Carta:  61853201  CHF  71.95;-71.95;55601.12;11.12.21
13.12.21;Eft-Pos DD 8105 REGENSDORF   11.12.2021 16:48 Carta:  61853201  CHF  72.70;-72.70;55673.07;11.12.21
13.12.21;Eft-Pos Coop-2572 Regensdorf 10.12.2021 19:21 Carta:  61853201  CHF  62.70;-62.70;55745.77;10.12.21
10.12.21;Spesen f�r Papierdokument(e);-1.50;55808.47;10.12.21
08.12.21;Verg�tung;-1000.00;55809.97;08.12.21
03.12.21;Zahlungseingang;13.60;56809.97;03.12.21
02.12.21;Belastung LSV;-310.00;56796.37;02.12.21
02.12.21;Belastung LSV;-7.00;57106.37;02.12.21
02.12.21;Eft-Pos Lidl Regensdorf      30.11.2021 18:20 Carta:  61853201  CHF  53.85;-53.85;57113.37;30.11.21
30.11.21;Verg�tung;-25.55;57167.22;30.11.21
30.11.21;Eft-Pos Coop-1506 Regensdorf 29.11.2021 14:55 Carta:  61853201  CHF  67.95;-67.95;57192.77;29.11.21
29.11.21;Verg�tung;-600.00;57260.72;29.11.21
29.11.21;Addebito TWINT , Schoko, +41782332263 0400000512708192;-30.00;57860.72;29.11.21
29.11.21;Prelevamento al Bancomat UBS Zuerich Central  27.11.2021 16:34 Carta:  61853201  CHF  100.00;-102.00;57890.72;27.11.21
26.11.21;Verg�tung;-1000.00;57992.72;26.11.21
25.11.21;Zahlungseingang;4227.45;58992.72;25.11.21
25.11.21;Eft-Pos ZH Limmatplatz       24.11.2021 14:10 Carta:  61853201  CHF  2.20;-2.20;54765.27;24.11.21
23.11.21;Eft-Pos LANDI Regensdorf Gen 22.11.2021 15:20 Carta:  61853201  CHF  25.50;-25.50;54767.47;22.11.21
23.11.21;Eft-Pos LANDI Regensdorf Gen 22.11.2021 15:19 Carta:  61853201  CHF  26.30;-26.30;54792.97;22.11.21
22.11.21;Zahlungseingang;200.00;54819.27;22.11.21
22.11.21;Eft-Pos Coop-2572 Regensdorf 19.11.2021 17:32 Carta:  61853201  CHF  82.75;-82.75;54619.27;19.11.21
22.11.21;Eft-Pos Lidl Regensdorf      19.11.2021 18:21 Carta:  61853201  CHF  49.10;-49.10;54702.02;19.11.21
17.11.21;Eft-Pos Lidl Regensdorf      15.11.2021 11:00 Carta:  61853201  CHF  45.40;-45.40;54751.12;15.11.21
16.11.21;Eft-Pos AKSA FOOD HONGG AG   13.11.2021 15:27 Carta:  61853201  CHF  36.15;-36.15;54796.52;13.11.21
15.11.21;Belastung LSV;-319.45;54832.67;15.11.21
11.11.21;Eft-Pos Aldi Suisse 79       10.11.2021 17:56 Carta:  61853201  CHF  24.05;-24.05;55152.12;10.11.21
11.11.21;Eft-Pos Lidl Regensdorf      09.11.2021 18:16 Carta:  61853201  CHF  61.60;-61.60;55176.17;09.11.21
10.11.21;Spesen f�r Papierdokument(e);-1.50;55237.77;10.11.21
08.11.21;Eft-Pos Coop-2572 Regensdorf 06.11.2021 20:07 Carta:  61853201  CHF  266.50;-266.50;55239.27;06.11.21
08.11.21;Eft-Pos Volg Laden Watt      06.11.2021 18:56 Carta:  61853201  CHF  13.00;-13.00;55505.77;06.11.21
08.11.21;Eft-Pos Volg Laden Watt      06.11.2021 18:50 Carta:  61853201  CHF  24.00;-24.00;55518.77;06.11.21
05.11.21;Eft-Pos Clever Fit           04.11.2021 10:29 Carta:  61853201  CHF  774.00;-774.00;55542.77;04.11.21
05.11.21;Eft-Pos Lidl Regensdorf      03.11.2021 19:48 Carta:  61853201  CHF  40.40;-40.40;56316.77;03.11.21
01.11.21;Belastung LSV;-7.00;56357.17;01.11.21
01.11.21;Belastung LSV;-310.00;56364.17;01.11.21
01.11.21;Eft-Pos Coop-2572 Regensdorf 30.10.2021 18:58 Carta:  61853201  CHF  38.35;-38.35;56674.17;30.10.21
29.10.21;Verg�tung;-35.40;56712.52;29.10.21
29.10.21;Verg�tung;-35.40;56747.92;29.10.21
28.10.21;Verg�tung;-600.00;56783.32;28.10.21
27.10.21;Zahlungseingang;4062.10;57383.32;27.10.21
27.10.21;Eft-Pos Gidor Coiffure       25.10.2021 18:46 Carta:  61853201  CHF  43.00;-43.00;53321.22;25.10.21
26.10.21;Eft-Pos Lidl Regensdorf      23.10.2021 20:13 Carta:  61853201  CHF  57.05;-57.05;53364.22;23.10.21
19.10.21;Eft-Pos Elvetino AG          18.10.2021 14:26 Carta:  61853201  CHF  4.60;-4.60;53421.27;18.10.21
14.10.21;Belastung LSV;-12.20;53425.87;14.10.21
14.10.21;Eft-Pos Lidl Regensdorf      12.10.2021 14:34 Carta:  61853201  CHF  33.95;-33.95;53438.07;12.10.21
13.10.21;Eft-Pos LANDI Regensdorf Gen 12.10.2021 14:16 Carta:  61853201  CHF  9.95;-9.95;53472.02;12.10.21
11.10.21;Spesen f�r Papierdokument(e);-1.50;53481.97;11.10.21
11.10.21;Addebito TWINT Ogg The Farmer 0400000461302003;-4.00;53483.47;11.10.21
11.10.21;Eft-Pos Coop-2572 Regensdorf 09.10.2021 19:44 Carta:  61853201  CHF  174.65;-174.65;53487.47;09.10.21
11.10.21;Eft-Pos IKEA Parking Dietlik 08.10.2021 18:19 Carta:  61853201  CHF  4.00;-4.00;53662.12;08.10.21
11.10.21;Eft-Pos Lidl Regensdorf      08.10.2021 13:18 Carta:  61853201  CHF  105.00;-105.00;53666.12;08.10.21
07.10.21;Eft-Pos SV (Schweiz) AG, 279 06.10.2021 20:22 Carta:  61853201  CHF  19.90;-19.90;53771.12;06.10.21
05.10.21;Verg�tung;-1000.00;53791.02;05.10.21
05.10.21;Eft-Pos Post CH AG (8364) Re 04.10.2021 11:44 Carta:  61853201  CHF  30.00;-30.00;54791.02;04.10.21
04.10.21;Zahlungseingang;550.00;54821.02;04.10.21
04.10.21;Belastung LSV;-7.00;54271.02;04.10.21
04.10.21;Eft-Pos Coop-2572 Regensdorf 02.10.2021 17:11 Carta:  61853201  CHF  57.85;-57.85;54278.02;02.10.21
01.10.21;Verg�tung;-600.00;54335.87;01.10.21
01.10.21;Eft-Pos Lidl Regensdorf      29.09.2021 15:02 Carta:  61853201  CHF  58.60;-58.60;54935.87;29.09.21
30.09.21;Belastung LSV;-310.00;54994.47;30.09.21
30.09.21;Verg�tung;-59.20;55304.47;30.09.21
29.09.21;Eft-Pos TEDi Fil  5580       27.09.2021 12:58 Carta:  61853201;-128.85;55363.67;27.09.21
24.09.21;Eft-Pos Lidl Regensdorf      22.09.2021 14:45 Carta:  61853201  CHF  63.95;-63.95;55492.52;22.09.21
23.09.21;Zahlungseingang;2814.65;55556.47;23.09.21
20.09.21;Eft-Pos LANDI Regensdorf Gen 18.09.2021 15:00 Carta:  61853201  CHF  50.30;-50.30;52741.82;18.09.21
16.09.21;Addebito TWINT Coop-2572 Regensdorf/R�gi-M�rt 0400000437106714;-26.75;52792.12;16.09.21
14.09.21;Belastung LSV;-26.15;52818.87;14.09.21
13.09.21;Eft-Pos Post CH AG (8364) Re 10.09.2021 15:00 Carta:  61853201  CHF  24.00;-24.00;52845.02;10.09.21
13.09.21;Eft-Pos LANDI Regensdorf Gen 10.09.2021 15:23 Carta:  61853201  CHF  19.80;-19.80;52869.02;10.09.21
13.09.21;Eft-Pos Lidl Regensdorf      10.09.2021 18:26 Carta:  61853201  CHF  44.10;-44.10;52888.82;10.09.21
10.09.21;Spesen f�r Papierdokument(e);-1.50;52932.92;10.09.21
08.09.21;Eft-Pos Consolato Generale d 06.09.2021 10:46 Carta:  61853201  CHF  128.60;-128.60;52934.42;06.09.21
07.09.21;Eft-Pos Coop TS Thalwil      05.09.2021 16:08 Carta:  61853201  CHF  5.55;-5.55;53063.02;05.09.21
07.09.21;Eft-Pos Lidl Regensdorf      04.09.2021 19:36 Carta:  61853201  CHF  37.50;-37.50;53068.57;04.09.21
03.09.21;Eft-Pos Volg Laden Watt      02.09.2021 17:53 Carta:  61853201  CHF  5.15;-5.15;53106.07;02.09.21
01.09.21;Zahlungseingang;2633.95;53111.22;01.09.21
01.09.21;Belastung LSV;-7.00;50477.27;01.09.21
31.08.21;Belastung LSV;-310.00;50484.27;31.08.21
31.08.21;Verg�tung;-20.60;50794.27;31.08.21
31.08.21;Eft-Pos DD 8105 REGENSDORF   30.08.2021 18:34 Carta:  61853201  CHF  23.60;-23.60;50814.87;30.08.21
31.08.21;Eft-Pos Lidl Zuerich         28.08.2021 18:25 Carta:  61853201  CHF  20.65;-20.65;50838.47;28.08.21
31.08.21;Eft-Pos AKSA FOOD HONGG AG   28.08.2021 17:59 Carta:  61853201  CHF  5.90;-5.90;50859.12;28.08.21
30.08.21;Verg�tung;-800.00;50865.02;30.08.21
30.08.21;Eft-Pos Lidl Regensdorf      27.08.2021 18:55 Carta:  61853201  CHF  73.10;-73.10;51665.02;27.08.21
27.08.21;Verg�tung;-60.00;51738.12;27.08.21
27.08.21;Eft-Pos Lidl Regensdorf      25.08.2021 19:05 Carta:  61853201  CHF  72.50;-72.50;51798.12;25.08.21
26.08.21;Eft-Pos Coop-2572 Regensdorf 25.08.2021 16:22 Carta:  61853201  CHF  67.45;-67.45;51870.62;25.08.21
23.08.21;Eft-Pos Coop-2572 Regensdorf 20.08.2021 18:32 Carta:  61853201  CHF  15.60;-15.60;51938.07;20.08.21
23.08.21;Eft-Pos AKSA FOOD HONGG AG   20.08.2021 17:35 Carta:  61853201  CHF  4.15;-4.15;51953.67;20.08.21
23.08.21;Eft-Pos Lidl Regensdorf      20.08.2021 19:19 Carta:  61853201  CHF  72.25;-72.25;51957.82;20.08.21
19.08.21;Eft-Pos Selecta AG / PrV     18.08.2021 14:08 Carta:  61853201  CHF  2.60;-2.60;52030.07;18.08.21
17.08.21;Eft-Pos BURGER KING REGENSDO 15.08.2021 20:49 Carta:  61853201  CHF  50.30;-50.30;52032.67;15.08.21
16.08.21;Belastung LSV;-258.05;52082.97;16.08.21
16.08.21;Eft-Pos Lidl Regensdorf      12.08.2021 19:37 Carta:  61853201  CHF  72.90;-72.90;52341.02;12.08.21
12.08.21;Eft-Pos AKSA FOOD HONGG AG   10.08.2021 19:02 Carta:  61853201  CHF  25.15;-25.15;52413.92;10.08.21
12.08.21;Eft-Pos AKSA FOOD HONGG AG   10.08.2021 19:07 Carta:  61853201  CHF  11.35;-11.35;52439.07;10.08.21
10.08.21;Spesen f�r Papierdokument(e);-1.50;52450.42;10.08.21
06.08.21;Verg�tung;-62.25;52451.92;06.08.21
04.08.21;Verg�tung;-1000.00;52514.17;04.08.21
02.08.21;Belastung LSV;-7.00;53514.17;02.08.21
02.08.21;Belastung LSV;-310.00;53521.17;02.08.21
02.08.21;Belastung LSV;-57.50;53831.17;02.08.21
30.07.21;Zahlungseingang;1479.85;53888.67;30.07.21
30.07.21;Verg�tung;-19.00;52408.82;30.07.21
19.07.21;Eft-Pos MM Regensdorf, Zentr 17.07.2021 16:32 Carta:  61853201  CHF  65.10;-65.10;52427.82;17.07.21
15.07.21;Verg�tung;-1000.00;52492.92;15.07.21
15.07.21;Eft-Pos Lidl Regensdorf      13.07.2021 20:05 Carta:  61853201  CHF  157.35;-157.35;53492.92;13.07.21
14.07.21;Belastung LSV;-166.65;53650.27;14.07.21
14.07.21;Eft-Pos Coop-2572 Regensdorf 13.07.2021 18:26 Carta:  61853201  CHF  93.40;-93.40;53816.92;13.07.21
12.07.21;Spesen f�r Papierdokument(e);-1.50;53910.32;12.07.21
09.07.21;Verg�tung;-39.00;53911.82;09.07.21
07.07.21;Eft-Pos Lidl Regensdorf      05.07.2021 19:18 Carta:  61853201  CHF  65.25;-65.25;53950.82;05.07.21
06.07.21;Eft-Pos Coop-1506 Regensdorf 05.07.2021 11:44 Carta:  61853201  CHF  3.20;-3.20;54016.07;05.07.21
06.07.21;Eft-Pos C & A Mode Regensdor 05.07.2021 11:40 Carta:  61853201  CHF  178.05;-178.05;54019.27;05.07.21
06.07.21;Eft-Pos TopPharm Zentrums-Ap 05.07.2021 10:32 Carta:  61853201  CHF  72.35;-72.35;54197.32;05.07.21
06.07.21;Eft-Pos Post CH AG (8364) Re 05.07.2021 10:46 Carta:  61853201  CHF  18.00;-18.00;54269.67;05.07.21
06.07.21;Eft-Pos LANDI Regensdorf Gen 05.07.2021 18:50 Carta:  61853201  CHF  7.40;-7.40;54287.67;05.07.21
05.07.21;Eft-Pos Volg Laden Watt      03.07.2021 15:00 Carta:  61853201  CHF  4.80;-4.80;54295.07;03.07.21
05.07.21;Eft-Pos DD 8105 REGENSDORF   02.07.2021 18:24 Carta:  61853201  CHF  61.65;-61.65;54299.87;02.07.21
02.07.21;Eft-Pos Volg Laden Watt      01.07.2021 19:58 Carta:  61853201  CHF  4.10;-4.10;54361.52;01.07.21
02.07.21;Eft-Pos AKSA FOOD HONGG AG   30.06.2021 11:01 Carta:  61853201  CHF  29.45;-29.45;54365.62;30.06.21
02.07.21;Eft-Pos Lidl Regensdorf      30.06.2021 17:33 Carta:  61853201  CHF  63.35;-63.35;54395.07;30.06.21
01.07.21;Belastung LSV;-7.00;54458.42;01.07.21
30.06.21;Belastung LSV;-290.35;54465.42;30.06.21
30.06.21;Verg�tung;-20.60;54755.77;30.06.21
28.06.21;Verg�tung;-400.00;54776.37;28.06.21
28.06.21;Zahlungseingang;4227.45;55176.37;28.06.21
28.06.21;Eft-Pos Lidl Regensdorf      25.06.2021 18:56 Carta:  61853201  CHF  148.85;-148.85;50948.92;25.06.21
25.06.21;Eft-Pos Lidl Regensdorf      23.06.2021 11:29 Carta:  61853201  CHF  77.90;-77.90;51097.77;23.06.21
22.06.21;Zahlungseingang;182.50;51175.67;22.06.21
21.06.21;Eft-Pos DD 8105 REGENSDORF   18.06.2021 18:59 Carta:  61853201  CHF  13.50;-13.50;50993.17;18.06.21
18.06.21;Verg�tung;-1000.00;51006.67;18.06.21
18.06.21;Eft-Pos Lidl Regensdorf      16.06.2021 17:57 Carta:  61853201  CHF  78.35;-78.35;52006.67;16.06.21
17.06.21;Zahlungseingang;2997.10;52085.02;17.06.21
17.06.21;Verg�tung;-85.00;49087.92;17.06.21
14.06.21;Belastung LSV;-6.10;49172.92;14.06.21
14.06.21;Eft-Pos Lidl Regensdorf      11.06.2021 18:52 Carta:  61853201  CHF  73.35;-73.35;49179.02;11.06.21
10.06.21;Spesen f�r Papierdokument(e);-1.50;49252.37;10.06.21
10.06.21;Eft-Pos Lidl Regensdorf      08.06.2021 18:21 Carta:  61853201  CHF  180.40;-180.40;49253.87;08.06.21
08.06.21;Verg�tung;-39.00;49434.27;08.06.21
08.06.21;Eft-Pos Post CH AG (8364) Re 07.06.2021 16:19 Carta:  61853201  CHF  12.00;-12.00;49473.27;07.06.21
08.06.21;Eft-Pos DD 8105 REGENSDORF   05.06.2021 16:16 Carta:  61853201  CHF  67.85;-67.85;49485.27;05.06.21
07.06.21;Addebito TWINT Ogg The Farmer 0400000346731776;-5.50;49553.12;07.06.21
02.06.21;Verg�tung;-750.00;49558.62;02.06.21
01.06.21;Eft-Pos TopPharm Zentrums-Ap 31.05.2021 11:54 Carta:  61853201  CHF  72.35;-72.35;50308.62;31.05.21
01.06.21;Eft-Pos Post CH AG (8364) Re 31.05.2021 16:51 Carta:  61853201  CHF  37.00;-37.00;50380.97;31.05.21
01.06.21;Eft-Pos Volg Laden Watt      31.05.2021 16:08 Carta:  61853201  CHF  8.65;-8.65;50417.97;31.05.21
01.06.21;Eft-Pos Gemeindeverwaltung R 31.05.2021 10:57 Carta:  61853201  CHF  40.00;-40.00;50426.62;31.05.21
31.05.21;Belastung LSV;-4.00;50466.62;31.05.21
31.05.21;Belastung LSV;-288.35;50470.62;31.05.21
31.05.21;Verg�tung;-43.40;50758.97;31.05.21
31.05.21;Eft-Pos Volg Laden Watt      29.05.2021 17:37 Carta:  61853201  CHF  9.10;-9.10;50802.37;29.05.21
31.05.21;Eft-Pos Lidl Regensdorf      28.05.2021 11:14 Carta:  61853201  CHF  137.40;-137.40;50811.47;28.05.21
28.05.21;Eft-Pos Coop-1511 Stadelhofe 27.05.2021 17:11 Carta:  61853201  CHF  3.95;-3.95;50948.87;27.05.21
25.05.21;Eft-Pos QUALIPET Center      22.05.2021 19:11 Carta:  61853201  CHF  5.50;-5.50;50952.82;22.05.21
25.05.21;Eft-Pos Coop-1506 Regensdorf 22.05.2021 19:31 Carta:  61853201  CHF  31.00;-31.00;50958.32;22.05.21
25.05.21;Eft-Pos Forbidden Planet AG  22.05.2021 18:28 Carta:  61853201  CHF  39.00;-39.00;50989.32;22.05.21
25.05.21;Eft-Pos MM Regensdorf, Zentr 22.05.2021 17:18 Carta:  61853201  CHF  100.20;-100.20;51028.32;22.05.21
25.05.21;Eft-Pos DD 8105 REGENSDORF   21.05.2021 18:35 Carta:  61853201  CHF  12.90;-12.90;51128.52;21.05.21
25.05.21;Eft-Pos Lidl Regensdorf      20.05.2021 17:37 Carta:  61853201  CHF  14.25;-14.25;51141.42;20.05.21
18.05.21;Verg�tung;-1614.95;51155.67;18.05.21
17.05.21;Verg�tung;-28.20;52770.62;17.05.21
14.05.21;Belastung LSV;-15.60;52798.82;14.05.21
11.05.21;Verg�tung;-102.60;52814.42;11.05.21
10.05.21;Spesen f�r Papierdokument(e);-1.50;52917.02;10.05.21
10.05.21;Verg�tung;-1000.00;52918.52;10.05.21
28.04.21;Verg�tung;-1000.00;53918.52;28.04.21
23.04.21;Pagamento stipendio Universitaet Zuerich;6057.60;54918.52;23.04.21
22.04.21;Verg�tung;-100.00;48860.92;22.04.21
20.04.21;Zahlungseingang;288.35;48960.92;20.04.21
20.04.21;Eft-Pos Amavita Regensdorf 1 17.04.2021 16:55 Carta:  61853201  CHF  19.90;-19.90;48672.57;17.04.21
19.04.21;Eft-Pos LANDI Regensdorf Gen 17.04.2021 16:26 Carta:  61853201  CHF  69.75;-69.75;48692.47;17.04.21
19.04.21;Eft-Pos Coop-1506 Regensdorf 17.04.2021 17:35 Carta:  61853201  CHF  69.85;-69.85;48762.22;17.04.21
19.04.21;Prelevamento al Bancomat BM Zentrum 8105 Regensdorf 17.04.2021 17:18 Carta: 61853201   ;-100.00;48832.07;17.04.21
15.04.21;Eft-Pos Brokids              14.04.2021 17:46 Carta:  61853201  CHF  4.00;-4.00;48932.07;14.04.21
14.04.21;Belastung LSV;-15.50;48936.07;14.04.21
13.04.21;Verg�tung;-39.00;48951.57;13.04.21
13.04.21;Eft-Pos Selecta AG / PrV     12.04.2021 13:28 Carta:  61853201  CHF  2.00;-2.00;48990.57;12.04.21
13.04.21;Eft-Pos Selecta AG / PrV     12.04.2021 13:27 Carta:  61853201  CHF  2.00;-2.00;48992.57;12.04.21
13.04.21;Eft-Pos STARBUCKS 040002     10.04.2021 16:20 Carta:  61853201  CHF  6.90;-6.90;48994.57;10.04.21
12.04.21;Spesen f�r Papierdokument(e);-1.50;49001.47;12.04.21
12.04.21;Eft-Pos MM Regensdorf, Zentr 10.04.2021 15:15 Carta:  61853201  CHF  110.60;-110.60;49002.97;10.04.21
12.04.21;Eft-Pos Zentrum Regensdorf A 10.04.2021 15:18 Carta:  61853201  CHF  0.50;-0.50;49113.57;10.04.21
06.04.21;Eft-Pos Aksam Supermarkt-Met 03.04.2021 14:51 Carta:  61853201  CHF  52.90;-52.90;49114.07;03.04.21
06.04.21;Eft-Pos AKSA FOOD HONGG AG   03.04.2021 14:58 Carta:  61853201  CHF  20.55;-20.55;49166.97;03.04.21
06.04.21;Eft-Pos BURGER KING REGENSDO 01.04.2021 20:50 Carta:  61853201  CHF  56.60;-56.60;49187.52;01.04.21
06.04.21;Eft-Pos Asiaway AG           01.04.2021 12:15 Carta:  61853201  CHF  6.30;-6.30;49244.12;01.04.21
01.04.21;Belastung LSV;-28.00;49250.42;01.04.21
31.03.21;Belastung LSV;-288.35;49278.42;31.03.21
29.03.21;Zahlungseingang;0.03;49566.77;29.03.21
29.03.21;Verg�tung;-0.05;49566.74;29.03.21
29.03.21;Verg�tung;-1550.00;49566.79;29.03.21
25.03.21;Pagamento stipendio Universitaet Zuerich;4596.15;51116.79;25.03.21
22.03.21;Eft-Pos Coop-1506 Regensdorf 20.03.2021 14:40 Carta:  61853201  CHF  64.05;-64.05;46520.64;20.03.21
22.03.21;Eft-Pos LANDI Regensdorf Gen 19.03.2021 18:37 Carta:  61853201  CHF  120.65;-120.65;46584.69;19.03.21
18.03.21;Eft-Pos Coop-2572 Regensdorf 17.03.2021 18:07 Carta:  61853201  CHF  69.15;-69.15;46705.34;17.03.21
17.03.21;Verg�tung;-478.50;46774.49;17.03.21
16.03.21;Storno Eft-Pos GENUINITY            09.03.2021 17:46 Carta:  61853201  CHF  6.10;6.10;47252.99;09.03.21
15.03.21;Belastung LSV;-25.30;47246.89;15.03.21
15.03.21;Verg�tung;-1000.00;47272.19;15.03.21
15.03.21;Eft-Pos Asia Store GmbH      12.03.2021 14:09 Carta:  61853201  CHF  51.00;-51.00;48272.19;12.03.21
15.03.21;Eft-Pos FRISCH-FISCH MERCATO 12.03.2021 16:30 Carta:  61853201  CHF  45.05;-45.05;48323.19;12.03.21
12.03.21;Eft-Pos Agrola Tankstelle Re 11.03.2021 18:17 Carta:  61853201  CHF  36.35;-36.35;48368.24;11.03.21
12.03.21;Eft-Pos GENUINITY            09.03.2021 17:46 Carta:  61853201  CHF  6.10;-6.10;48404.59;09.03.21
12.03.21;Eft-Pos GENUINITY            09.03.2021 17:46 Carta:  61853201  CHF  6.10;-6.10;48410.69;09.03.21
10.03.21;Spesen f�r Papierdokument(e);-2.50;48416.79;10.03.21
10.03.21;Eft-Pos Coop-1381 Ascona     09.03.2021 18:16 Carta:  61853201  CHF  94.70;-94.70;48419.29;09.03.21
10.03.21;Eft-Pos COOP DI CONSUMO      08.03.2021 17:45 Carta:  61853201  CHF  98.70;-98.70;48513.99;08.03.21
09.03.21;Eft-Pos Gialur Sagl          08.03.2021 10:43 Carta:  61853201  CHF  28.05;-28.05;48612.69;08.03.21
09.03.21;Eft-Pos Autosilo Central Par 07.03.2021 19:13 Carta:  61853201  CHF  6.00;-6.00;48640.74;07.03.21
09.03.21;Eft-Pos Fondazione culture e 07.03.2021 16:33 Carta:  61853201  CHF  35.00;-35.00;48646.74;07.03.21
09.03.21;Eft-Pos SumUp  *Osteria  Deg 07.03.2021 14:27 Carta:  61853201  CHF  86.00;-86.00;48681.74;07.03.21
09.03.21;Eft-Pos SumUp  *Mystic       06.03.2021 17:56 Carta:  61853201  CHF  17.00;-17.00;48767.74;06.03.21
08.03.21;Verg�tung;-1000.00;48784.74;08.03.21
08.03.21;Verg�tung;-39.00;49784.74;08.03.21
05.03.21;Verg�tung;-21.75;49823.74;05.03.21
01.03.21;Belastung LSV;-288.35;49845.49;01.03.21
26.02.21;Eft-Pos Lidl Regensdorf      24.02.2021 00:00 Carta:  61853201  CHF  60.35;-60.35;50133.84;24.02.21
25.02.21;Pagamento stipendio Universitaet Zuerich;4596.15;50194.19;25.02.21
23.02.21;Eft-Pos Migrol Altdorf UR    21.02.2021 13:40 Carta:  61853201  CHF  16.65;-16.65;45598.04;21.02.21
23.02.21;Eft-Pos Strueby Automobile   21.02.2021 00:00 Carta:  61853201  CHF  28.23;-28.23;45614.69;21.02.21
22.02.21;Eft-Pos Lidl Regensdorf      19.02.2021 00:00 Carta:  61853201  CHF  37.45;-37.45;45642.92;19.02.21
15.02.21;Belastung LSV;-41.40;45680.37;15.02.21
12.02.21;Entrata pagamento POSTFINANCE AG;100.00;45721.77;12.02.21
11.02.21;Eft-Pos Coop-2572 Regensdorf 10.02.2021 18:08 Carta:  61853201  CHF  42.85;-42.85;45621.77;10.02.21
10.02.21;Spesen f�r Papierdokument(e);-1.50;45664.62;10.02.21
08.02.21;Verg�tung;-139.00;45666.12;08.02.21
08.02.21;Eft-Pos Lidl Regensdorf      04.02.2021 00:00 Carta:  61853201  CHF  48.85;-48.85;45805.12;04.02.21
03.02.21;Verg�tung;-19.00;45853.97;03.02.21
01.02.21;Belastung LSV;-288.35;45872.97;01.02.21
01.02.21;Eft-Pos Coop-1506 Regensdorf 30.01.2021 14:41 Carta:  61853201  CHF  198.45;-198.45;46161.32;30.01.21
25.01.21;Pagamento stipendio Universitaet Zuerich;4596.15;46359.77;25.01.21
25.01.21;Verg�tung;-1000.00;41763.62;25.01.21
25.01.21;Eft-Pos Volg Laden Watt      23.01.2021 18:02 Carta:  61853201  CHF  20.10;-20.10;42763.62;23.01.21
19.01.21;Eft-Pos LANDI Regensdorf Gen 18.01.2021 18:47 Carta:  61853201  CHF  127.55;-127.55;42783.72;18.01.21
18.01.21;Eft-Pos Lidl Regensdorf      14.01.2021 18:57 Carta:  61853201  CHF  121.85;-121.85;42911.27;14.01.21
15.01.21;Verg�tung;-39.00;43033.12;15.01.21
14.01.21;Verg�tung;-201.05;43072.12;14.01.21
14.01.21;Belastung LSV;-9.20;43273.17;14.01.21
11.01.21;Spesen f�r Papierdokument(e);-1.50;43282.37;11.01.21
11.01.21;Verg�tung;-19.00;43283.87;11.01.21
11.01.21;Eft-Pos Lidl Regensdorf      08.01.2021 12:54 Carta:  61853201  CHF  24.10;-24.10;43302.87;08.01.21
06.01.21;Eft-Pos Lidl Regensdorf      04.01.2021 18:40 Carta:  61853201  CHF  85.10;-85.10;43326.97;04.01.21
04.01.21;Verg�tung;-1000.00;43412.07;04.01.21
31.12.20;Zahlungsverkehrsspesen;-3.20;44412.07;31.12.20
31.12.20;Belastung LSV;-288.35;44415.27;31.12.20
31.12.20;Eft-Pos Coop-2017 Regensdorf 30.12.2020 10:59 Carta:  61853201  CHF  31.10;-31.10;44703.62;30.12.20
29.12.20;Eft-Pos Coop-2572 Regensdorf 28.12.2020 10:29 Carta:  61853201  CHF  4.90;-4.90;44734.72;28.12.20
29.12.20;Eft-Pos Coop-2572 Regensdorf 28.12.2020 10:27 Carta:  61853201  CHF  33.10;-33.10;44739.62;28.12.20
28.12.20;Eft-Pos FRISCH-FISCH MERCATO 23.12.2020 11:58 Carta:  61853201  CHF  77.60;-77.60;44772.72;23.12.20
24.12.20;Eft-Pos DD 8105 REGENSDORF   23.12.2020 13:31 Carta:  61853201  CHF  26.45;-26.45;44850.32;23.12.20
24.12.20;Eft-Pos FRISCH-FISCH MERCATO 22.12.2020 17:47 Carta:  61853201  CHF  66.10;-66.10;44876.77;22.12.20
23.12.20;Eft-Pos Otto's AG 16, Dietik 22.12.2020 18:00 Carta:  61853201  CHF  4.15;-4.15;44942.87;22.12.20
21.12.20;Eft-Pos Coop-1417 ZH Hofwies 19.12.2020 18:57 Carta:  61853201  CHF  6.40;-6.40;44947.02;19.12.20
18.12.20;Eft-Pos Lidl Regensdorf      16.12.2020 17:41 Carta:  61853201  CHF  12.70;-12.70;44953.42;16.12.20
18.12.20;Eft-Pos SumUp  *Schmids Schm 16.12.2020 17:32 Carta:  61853201  CHF  30.00;-30.00;44966.12;16.12.20
15.12.20;Pagamento stipendio Universitaet Zuerich;9188.45;44996.12;15.12.20
15.12.20;Eft-Pos Sport-Fabrik AG      14.12.2020 16:24 Carta:  61853201  CHF  59.70;-59.70;35807.67;14.12.20
15.12.20;Eft-Pos Lidl Regensdorf      12.12.2020 11:56 Carta:  61853201  CHF  71.65;-71.65;35867.37;12.12.20
14.12.20;Belastung LSV;-311.15;35939.02;14.12.20
11.12.20;Eft-Pos Lidl Regensdorf      09.12.2020 17:34 Carta:  61853201  CHF  61.75;-61.75;36250.17;09.12.20
10.12.20;Verg�tung;-2000.00;36311.92;10.12.20
10.12.20;Spesen f�r Papierdokument(e);-1.50;38311.92;10.12.20
09.12.20;Verg�tung;-39.00;38313.42;09.12.20
04.12.20;Verg�tung;-19.00;38352.42;04.12.20
01.12.20;Belastung LSV;-229.15;38371.42;01.12.20
01.12.20;Eft-Pos FRISCH-FISCH MERCATO 28.11.2020 16:51 Carta:  61853201  CHF  16.45;-16.45;38600.57;28.11.20
30.11.20;Verg�tung;-1000.00;38617.02;30.11.20
30.11.20;Eft-Pos Media Markt Dietikon 28.11.2020 17:57 Carta:  61853201  CHF  549.00;-549.00;39617.02;28.11.20
30.11.20;Eft-Pos Otto's AG 16, Dietik 28.11.2020 17:06 Carta:  61853201  CHF  53.85;-53.85;40166.02;28.11.20
30.11.20;Eft-Pos Lidl Regensdorf      27.11.2020 17:37 Carta:  61853201  CHF  12.05;-12.05;40219.87;27.11.20
25.11.20;Pagamento stipendio Universitaet Zuerich;4700.20;40231.92;25.11.20
25.11.20;Eft-Pos M�ller Handels AG Sc 24.11.2020 17:58 Carta:  61853201  CHF  29.60;-29.60;35531.72;24.11.20
25.11.20;Eft-Pos MM Regensdorf, Zentr 24.11.2020 18:14 Carta:  61853201  CHF  4.30;-4.30;35561.32;24.11.20
24.11.20;Eft-Pos DD 8105 REGENSDORF   23.11.2020 17:41 Carta:  61853201  CHF  36.00;-36.00;35565.62;23.11.20
18.11.20;Eft-Pos Coop-2572 Regensdorf 17.11.2020 17:58 Carta:  61853201  CHF  72.30;-72.30;35601.62;17.11.20
17.11.20;Eft-Pos Blausee Parking      14.11.2020 10:00 Carta:  61853201  CHF  3.00;-3.00;35673.92;14.11.20
17.11.20;Eft-Pos RESTAURANT-HOTEL BLA 14.11.2020 10:02 Carta:  61853201  CHF  26.00;-26.00;35676.92;14.11.20
16.11.20;Belastung LSV;-37.20;35702.92;16.11.20
16.11.20;Verg�tung;-1039.00;35740.12;16.11.20
16.11.20;Eft-Pos SumUp  *Tanner, Hote 13.11.2020 21:32 Carta:  61853201  CHF  168.00;-168.00;36779.12;13.11.20
16.11.20;Eft-Pos Lidl Regensdorf      12.11.2020 18:15 Carta:  61853201  CHF  90.80;-90.80;36947.12;12.11.20
13.11.20;Eft-Pos Coop-2017 Regensdorf 12.11.2020 17:37 Carta:  61853201  CHF  3.50;-3.50;37037.92;12.11.20
12.11.20;Entrata pagamento Coop-1506 Regensdorf 11.11.2020 17:19 Carta:  61853201  CHF  12.35;12.35;37041.42;11.11.20
12.11.20;Eft-Pos Coop-1506 Regensdorf 11.11.2020 17:14 Carta:  61853201  CHF  52.75;-52.75;37029.07;11.11.20
10.11.20;Spesen f�r Papierdokument(e);-1.50;37081.82;10.11.20
09.11.20;Eft-Pos SOCAR Tankstelle     07.11.2020 19:42 Carta:  61853201  CHF  3.60;-3.60;37083.32;07.11.20
09.11.20;Eft-Pos Lidl Regensdorf      06.11.2020 18:00 Carta:  61853201  CHF  69.60;-69.60;37086.92;06.11.20
03.11.20;Zahlungseingang;360.00;37156.52;03.11.20
02.11.20;Belastung LSV;-229.15;36796.52;02.11.20
02.11.20;Eft-Pos Coop-2572 Regensdorf 31.10.2020 18:56 Carta:  61853201  CHF  182.60;-182.60;37025.67;31.10.20
29.10.20;Prelevamento al Bancomat ZKB ZH Affoltern 1   28.10.2020 14:50 Carta:  61853201  CHF  100.00;-102.00;37208.27;28.10.20
29.10.20;Eft-Pos Lidl Regensdorf      27.10.2020 19:12 Carta:  61853201  CHF  81.15;-81.15;37310.27;27.10.20
27.10.20;Verg�tung;-1000.00;37391.42;27.10.20
27.10.20;Prelevamento al Bancomat FILIALE EINKAUFSZENT 24.10.2020 13:45 Carta:  61853201  CHF  100.00;-102.00;38391.42;24.10.20
26.10.20;Eft-Pos Coop-1506 Regensdorf 24.10.2020 18:02 Carta:  61853201  CHF  129.45;-129.45;38493.42;24.10.20
23.10.20;Pagamento stipendio Universitaet Zuerich;4700.20;38622.87;23.10.20
20.10.20;Eft-Pos UZH Binzm�hle        19.10.2020 13:04 Carta:  61853201  CHF  7.00;-7.00;33922.67;19.10.20
19.10.20;Verg�tung;-84.60;33929.67;19.10.20
19.10.20;Eft-Pos Coop-4953 Zug Bahnho 17.10.2020 18:10 Carta:  61853201  CHF  4.05;-4.05;34014.27;17.10.20
19.10.20;Eft-Pos Natur Tierpark-Ticke 17.10.2020 12:37 Carta:  61853201  CHF  70.00;-70.00;34018.32;17.10.20
16.10.20;Eft-Pos UZH Binzm�hle        15.10.2020 12:17 Carta:  61853201  CHF  7.00;-7.00;34088.32;15.10.20
16.10.20;Eft-Pos Coop-1417 ZH Hofwies 15.10.2020 20:12 Carta:  61853201  CHF  7.90;-7.90;34095.32;15.10.20
15.10.20;Verg�tung;-180.00;34103.22;15.10.20
14.10.20;Belastung LSV;-72.05;34283.22;14.10.20
14.10.20;Eft-Pos Decathlon            13.10.2020 16:58 Carta:  61853201  CHF  58.00;-58.00;34355.27;13.10.20
13.10.20;Eft-Pos Volg Laden Watt      12.10.2020 18:42 Carta:  61853201  CHF  10.25;-10.25;34413.27;12.10.20
13.10.20;Eft-Pos shopAgent Bagci & Da 11.10.2020 16:06 Carta:  61853201  CHF  10.00;-10.00;34423.52;11.10.20
12.10.20;Spesen f�r Papierdokument(e);-1.50;34433.52;12.10.20
12.10.20;Verg�tung;-126.55;34435.02;12.10.20
12.10.20;Prelevamento al Bancomat BM Badstrasse 8  5400 Baden 11.10.2020 12:10 Carta: 61853201   ;-100.00;34561.57;11.10.20
12.10.20;Eft-Pos H & M                10.10.2020 18:37 Carta:  61853201  CHF  115.15;-115.15;34661.57;10.10.20
12.10.20;Eft-Pos Coop-1914 ZH C.St. A 10.10.2020 19:29 Carta:  61853201  CHF  133.55;-133.55;34776.72;10.10.20
12.10.20;Eft-Pos Parkhaus Hauptbahnho 10.10.2020 19:51 Carta:  61853201  CHF  12.00;-12.00;34910.27;10.10.20
12.10.20;Eft-Pos Decathlon            09.10.2020 17:46 Carta:  61853201  CHF  80.00;-80.00;34922.27;09.10.20
12.10.20;Eft-Pos Decathlon            09.10.2020 17:41 Carta:  61853201  CHF  364.00;-364.00;35002.27;09.10.20
12.10.20;Eft-Pos Restaurant Luigia Z� 09.10.2020 19:40 Carta:  61853201  CHF  50.90;-50.90;35366.27;09.10.20
08.10.20;Eft-Pos Lidl Regensdorf      06.10.2020 12:50 Carta:  61853201  CHF  17.25;-17.25;35417.17;06.10.20
07.10.20;Verg�tung;-14.90;35434.42;07.10.20
05.10.20;Eft-Pos Coop-1506 Regensdorf 03.10.2020 19:14 Carta:  61853201  CHF  173.05;-173.05;35449.32;03.10.20
01.10.20;Belastung LSV;-229.15;35622.37;01.10.20
29.09.20;Eft-Pos UZH Binzm�hle        28.09.2020 12:54 Carta:  61853201  CHF  7.00;-7.00;35851.52;28.09.20
29.09.20;Eft-Pos LANDI Regensdorf Gen 28.09.2020 18:59 Carta:  61853201  CHF  30.20;-30.20;35858.52;28.09.20
28.09.20;Eft-Pos Lidl Regensdorf      24.09.2020 19:50 Carta:  61853201  CHF  34.45;-34.45;35888.72;24.09.20
25.09.20;Pagamento stipendio Universitaet Zuerich;4700.20;35923.17;25.09.20
22.09.20;Eft-Pos UZH Binzm�hle        21.09.2020 12:49 Carta:  61853201  CHF  5.40;-5.40;31222.97;21.09.20
21.09.20;Zahlungseingang;405.82;31228.37;21.09.20
21.09.20;Eft-Pos Talstation Harderbah 19.09.2020 16:52 Carta:  61853201  CHF  34.00;-34.00;30822.55;19.09.20
21.09.20;Eft-Pos TA Catering S. Aareg 19.09.2020 20:04 Carta:  61853201  CHF  24.00;-24.00;30856.55;19.09.20
17.09.20;Eft-Pos BURGER KING          14.09.2020 19:36 Carta:  61853201  CHF  45.80;-45.80;30880.55;14.09.20
14.09.20;Zahlungseingang;300.00;30926.35;14.09.20
14.09.20;Belastung LSV;-1010.50;30626.35;14.09.20
14.09.20;Verg�tung;-1000.00;31636.85;14.09.20
11.09.20;Verg�tung;-1160.65;32636.85;11.09.20
10.09.20;Spesen f�r Papierdokument(e);-1.50;33797.50;10.09.20
09.09.20;Eft-Pos Coop-2572 Regensdorf 08.09.2020 20:10 Carta:  61853201  CHF  40.30;-40.30;33799.00;08.09.20
08.09.20;Verg�tung;-40.00;33839.30;08.09.20
08.09.20;Eft-Pos Hong Kong Food Parad 07.09.2020 12:52 Carta:  61853201  CHF  23.80;-23.80;33879.30;07.09.20
08.09.20;Eft-Pos SCHWEIZ. BUNDESBAHN  06.09.2020 10:05 Carta:  61853201  CHF  14.00;-14.00;33903.10;06.09.20
08.09.20;Eft-Pos SBB LUZERN           06.09.2020 18:03 Carta:  61853201  CHF  14.00;-14.00;33917.10;06.09.20
08.09.20;Eft-Pos Lidl Regensdorf      05.09.2020 13:07 Carta:  61853201  CHF  67.95;-67.95;33931.10;05.09.20
01.09.20;Belastung LSV;-192.85;33999.05;01.09.20
01.09.20;Eft-Pos Coop-1506 Regensdorf 31.08.2020 18:02 Carta:  61853201  CHF  3.75;-3.75;34191.90;31.08.20
01.09.20;Eft-Pos Coop-1506 Regensdorf 31.08.2020 18:02 Carta:  61853201  CHF  113.60;-113.60;34195.65;31.08.20
01.09.20;Eft-Pos Lidl Regensdorf      29.08.2020 14:03 Carta:  61853201  CHF  77.00;-77.00;34309.25;29.08.20
31.08.20;Eft-Pos IKEA AG, Spreitenbac 28.08.2020 15:50 Carta:  61853201  CHF  5.50;-5.50;34386.25;28.08.20
31.08.20;Eft-Pos IKEA AG, Spreitenbac 28.08.2020 17:33 Carta:  61853201  CHF  133.50;-133.50;34391.75;28.08.20
31.08.20;Eft-Pos Lidl Regensdorf      28.08.2020 19:24 Carta:  61853201  CHF  44.15;-44.15;34525.25;28.08.20
27.08.20;Verg�tung;-2187.00;34569.40;27.08.20
25.08.20;Pagamento stipendio Universitaet Zuerich;4700.20;36756.40;25.08.20
24.08.20;Eft-Pos DD 8105 REGENSDORF   22.08.2020 12:56 Carta:  61853201  CHF  32.05;-32.05;32056.20;22.08.20
24.08.20;Eft-Pos LANDI Regensdorf Gen 22.08.2020 11:55 Carta:  61853201  CHF  16.25;-16.25;32088.25;22.08.20
24.08.20;Eft-Pos Coop-2017 Regensdorf 22.08.2020 12:40 Carta:  61853201  CHF  9.45;-9.45;32104.50;22.08.20
24.08.20;Prelevamento al Bancomat UBS Regensdorf Ind.  21.08.2020 16:00 Carta:  61853201  CHF  200.00;-202.00;32113.95;21.08.20
20.08.20;Eft-Pos Landi Seengen        19.08.2020 18:29 Carta:  61853201  CHF  50.80;-50.80;32315.95;19.08.20
19.08.20;Eft-Pos Coop-1506 Regensdorf 18.08.2020 20:03 Carta:  61853201  CHF  46.30;-46.30;32366.75;18.08.20
18.08.20;Eft-Pos DD 8105 REGENSDORF   17.08.2020 12:49 Carta:  61853201  CHF  35.20;-35.20;32413.05;17.08.20
17.08.20;Eft-Pos BAUHAUS Fachcentrum  14.08.2020 15:08 Carta:  61853201  CHF  52.05;-52.05;32448.25;14.08.20
17.08.20;Eft-Pos LANDI Regensdorf Gen 14.08.2020 16:43 Carta:  61853201  CHF  16.90;-16.90;32500.30;14.08.20
17.08.20;Eft-Pos Lidl Regensdorf      13.08.2020 19:31 Carta:  61853201  CHF  78.80;-78.80;32517.20;13.08.20
14.08.20;Eft-Pos LANDI Regensdorf Gen 13.08.2020 11:11 Carta:  61853201  CHF  148.80;-148.80;32596.00;13.08.20
13.08.20;Eft-Pos Coop-2017 Regensdorf 12.08.2020 12:29 Carta:  61853201  CHF  119.45;-119.45;32744.80;12.08.20
11.08.20;Eft-Pos Coop-2572 Regensdorf 10.08.2020 20:50 Carta:  61853201  CHF  82.10;-82.10;32864.25;10.08.20
10.08.20;Spesen f�r Papierdokument(e);-1.50;32946.35;10.08.20
10.08.20;Eft-Pos SumUp  *Fluonalp Alp 07.08.2020 22:06 Carta:  61853201  CHF  86.90;-86.90;32947.85;07.08.20
07.08.20;Prelevamento al Bancomat CS Regensdorf Spitex 06.08.2020 16:13 Carta:  61853201  CHF  200.00;-202.00;33034.75;06.08.20
07.08.20;Eft-Pos Gemeindeverwaltung R 06.08.2020 16:05 Carta:  61853201  CHF  215.00;-215.00;33236.75;06.08.20
06.08.20;Eft-Pos Coop-1506 Regensdorf 05.08.2020 17:39 Carta:  61853201  CHF  134.20;-134.20;33451.75;05.08.20
06.08.20;Eft-Pos Interdiscount-3579 R 05.08.2020 16:51 Carta:  61853201  CHF  6.95;-6.95;33585.95;05.08.20
06.08.20;Eft-Pos Interdiscount-3579 R 05.08.2020 16:49 Carta:  61853201  CHF  40.00;-40.00;33592.90;05.08.20
06.08.20;Eft-Pos AUTOGRILL 0310       04.08.2020 09:47 Carta:  61853201;-10.30;33632.90;04.08.20
06.08.20;Eft-Pos PV1276               04.08.2020 12:11 Carta:  61853201;-21.10;33643.20;04.08.20
06.08.20;Eft-Pos L'ANTICO FORNO CANU  04.08.2020 07:59 Carta:  61853201;-26.40;33664.30;04.08.20
06.08.20;Eft-Pos MERCATO COPERTO MERC 03.08.2020 18:47 Carta:  61853201;-70.50;33690.70;03.08.20
05.08.20;Eft-Pos CONAD                03.08.2020 19:43 Carta:  61853201;-121.05;33761.20;03.08.20
03.08.20;Belastung LSV;-265.45;33882.25;03.08.20
31.07.20;Verg�tung;-84.60;34147.70;31.07.20
27.07.20;Verg�tung;-2187.00;34232.30;27.07.20
24.07.20;Pagamento stipendio Universitaet Zuerich;4700.20;36419.30;24.07.20
15.07.20;Verg�tung;-6000.00;31719.10;15.07.20
10.07.20;Spesen f�r Papierdokument(e);-1.50;37719.10;10.07.20
08.07.20;Zahlungseingang;2633.25;37720.60;08.07.20
01.07.20;Belastung LSV;-265.45;35087.35;01.07.20
30.06.20;Verg�tung;-60.00;35352.80;30.06.20
29.06.20;Eft-Pos Agip stazione serviz 27.06.2020 12:34 Carta:  61853201  CHF  3.90;-3.90;35412.80;27.06.20
25.06.20;Pagamento stipendio Universitaet Zuerich;4700.20;35416.70;25.06.20
18.06.20;Zahlungseingang;1650.00;30716.50;18.06.20
10.06.20;Spesen f�r Papierdokument(e);-1.50;29066.50;10.06.20
02.06.20;Belastung LSV;-265.45;29068.00;02.06.20
27.05.20;Dauerauftrag;-900.00;29333.45;27.05.20
25.05.20;Pagamento stipendio Universitaet Zuerich;4971.45;30233.45;25.05.20
18.05.20;Verg�tung;-18.00;25262.00;18.05.20
14.05.20;Verg�tung;-29.00;25280.00;14.05.20
11.05.20;Spesen f�r Papierdokument(e);-1.50;25309.00;11.05.20
11.05.20;Verg�tung;-42.30;25310.50;11.05.20
04.05.20;Zahlungseingang;900.00;25352.80;04.05.20
04.05.20;Belastung LSV;-265.45;24452.80;04.05.20
27.04.20;Dauerauftrag;-900.00;24718.25;27.04.20
24.04.20;Pagamento stipendio Universitaet Zuerich;4971.45;25618.25;24.04.20
21.04.20;Verg�tung;-42.30;20646.80;21.04.20
14.04.20;Spesen f�r Papierdokument(e);-1.50;20689.10;14.04.20
07.04.20;Verg�tung;-126.90;20690.60;07.04.20
01.04.20;Belastung LSV;-265.45;20817.50;01.04.20
27.03.20;Dauerauftrag;-900.00;21082.95;27.03.20
25.03.20;Pagamento stipendio Universitaet Zuerich;4971.45;21982.95;25.03.20
10.03.20;Spesen f�r Papierdokument(e);-1.50;17011.50;10.03.20
06.03.20;Verg�tung;-3000.00;17013.00;06.03.20
05.03.20;Eft-Pos UZH Binzm�hle        04.03.2020 13:13 Carta:  61853201  CHF  7.70;-7.70;20013.00;04.03.20
04.03.20;Eft-Pos UZH Binzm�hle        03.03.2020 12:37 Carta:  61853201  CHF  11.90;-11.90;20020.70;03.03.20
04.03.20;Eft-Pos Aldi Suisse 06       03.03.2020 16:56 Carta:  61853201  CHF  8.45;-8.45;20032.60;03.03.20
04.03.20;Eft-Pos LIDL 211 - ZUERICH - 02.03.2020 17:28 Carta:  61853201  CHF  12.65;-12.65;20041.05;02.03.20
04.03.20;Eft-Pos Pressecenter Airport 02.03.2020 12:08 Carta:  61853201  CHF  3.25;-3.25;20053.70;02.03.20
04.03.20;Eft-Pos Hug Retail AG        02.03.2020 13:29 Carta:  61853201  CHF  8.80;-8.80;20056.95;02.03.20
03.03.20;Eft-Pos Coop-5609 ZH Andreas 02.03.2020 13:26 Carta:  61853201  CHF  7.15;-7.15;20065.75;02.03.20
27.02.20;Dauerauftrag;-900.00;20072.90;27.02.20
27.02.20;Eft-Pos UZH Binzm�hle        26.02.2020 12:30 Carta:  61853201  CHF  7.00;-7.00;20972.90;26.02.20
26.02.20;Eft-Pos UZH Binzm�hle        25.02.2020 12:48 Carta:  61853201  CHF  8.40;-8.40;20979.90;25.02.20
26.02.20;Eft-Pos Aldi Suisse 06       25.02.2020 18:58 Carta:  61853201  CHF  27.30;-27.30;20988.30;25.02.20
25.02.20;Pagamento stipendio Universitaet Zuerich;4971.45;21015.60;25.02.20
25.02.20;Eft-Pos UZH Binzm�hle        24.02.2020 13:09 Carta:  61853201  CHF  8.40;-8.40;16044.15;24.02.20
20.02.20;Eft-Pos UZH Binzm�hle        19.02.2020 12:27 Carta:  61853201  CHF  5.40;-5.40;16052.55;19.02.20
19.02.20;Eft-Pos UZH Binzm�hle        18.02.2020 12:31 Carta:  61853201  CHF  7.00;-7.00;16057.95;18.02.20
18.02.20;Eft-Pos UZH Binzm�hle        17.02.2020 12:53 Carta:  61853201  CHF  8.40;-8.40;16064.95;17.02.20
18.02.20;Eft-Pos Aldi Suisse 06       17.02.2020 17:12 Carta:  61853201  CHF  13.75;-13.75;16073.35;17.02.20
13.02.20;Eft-Pos UZH Binzm�hle        12.02.2020 12:28 Carta:  61853201  CHF  7.00;-7.00;16087.10;12.02.20
12.02.20;Eft-Pos UZH Binzm�hle        11.02.2020 12:40 Carta:  61853201  CHF  7.00;-7.00;16094.10;11.02.20
11.02.20;Eft-Pos Coop-1248 ZH Milchbu 10.02.2020 13:30 Carta:  61853201  CHF  57.10;-57.10;16101.10;10.02.20
11.02.20;Eft-Pos RESTAURANT GERTRUDHO 09.02.2020 17:11 Carta:  61853201  CHF  88.50;-88.50;16158.20;09.02.20
11.02.20;Prelevamento al Bancomat ZUERICH-LOCHERGUT    09.02.2020 16:04 Carta:  61853201  CHF  100.00;-102.00;16246.70;09.02.20
10.02.20;Spesen f�r Papierdokument(e);-3.00;16348.70;10.02.20
10.02.20;Eft-Pos Restaurant Luigia Z� 08.02.2020 22:31 Carta:  61853201  CHF  80.50;-80.50;16351.70;08.02.20
10.02.20;Eft-Pos Restaurant Luigia Z� 08.02.2020 20:55 Carta:  61853201  CHF  16.00;-16.00;16432.20;08.02.20
27.01.20;Dauerauftrag;-900.00;16448.20;27.01.20
24.01.20;Pagamento stipendio Universitaet Zuerich;4971.45;17348.20;24.01.20
15.01.20;Eft-Pos Aldi Suisse 06       14.01.2020 16:57 Carta:  61853201  CHF  4.20;-4.20;12376.75;14.01.20
14.01.20;Eft-Pos UZH Binzm�hle        13.01.2020 12:32 Carta:  61853201  CHF  11.90;-11.90;12380.95;13.01.20
13.01.20;Verg�tung;-2000.00;12392.85;13.01.20
10.01.20;Pagamento Bundesamt f�r Gesundheit BAG;-300.00;14392.85;10.01.20
10.01.20;Verg�tung;-400.00;14692.85;10.01.20
09.01.20;Verg�tung;-530.90;15092.85;09.01.20
09.01.20;Eft-Pos UZH Binzm�hle        08.01.2020 12:34 Carta:  61853201  CHF  7.00;-7.00;15623.75;08.01.20
09.01.20;Eft-Pos Selecta AG / PuV     08.01.2020 15:02 Carta:  61853201  CHF  3.00;-3.00;15630.75;08.01.20
09.01.20;Eft-Pos Selecta AG / PuV     08.01.2020 15:03 Carta:  61853201  CHF  3.00;-3.00;15633.75;08.01.20
08.01.20;Eft-Pos UZH Binzm�hle        07.01.2020 12:28 Carta:  61853201  CHF  7.00;-7.00;15636.75;07.01.20
07.01.20;Eft-Pos Aldi Suisse 06       06.01.2020 16:57 Carta:  61853201  CHF  9.45;-9.45;15643.75;06.01.20
07.01.20;Eft-Pos Restaurant Pantanal  05.01.2020 15:56 Carta:  61853201  CHF  3.80;-3.80;15653.20;05.01.20
06.01.20;Eft-Pos Coop-1914 ZH C.St. A 04.01.2020 19:29 Carta:  61853201  CHF  100.35;-100.35;15657.00;04.01.20
31.12.19;Saldovortrag;15757.35;15757.35;31.12.19
